Ürün Adı,Adet,min_date,max_date,date_diff,olumlu_sayi,olumsuz_sayi
TRENDYOLMİLLA Siyah Vücuda Oturan Degaje Yaka Midi Askılı Esnek Örme Midi Kalem Elbise TWOSS19AD0020,885,2022-03-22,2025-02-17,1063,802,83
TRENDYOLMİLLA Siyah Vücuda Oturan Mini Dik Yaka Fitilli Esnek Örme Kalem Elbise TWOAW21EL2244,712,2022-03-21,2025-03-10,1085,614,98
TRENDYOLMİLLA Siyah Fitted/ Vücuda Oturan Kolsuz Drape Detaylı Kemerli Midi Esnek Örme Kalem Elbise TWOSS22EL0756,706,2022-03-24,2025-03-07,1079,667,39
TRENDYOLMİLLA Lacivert Vücuda Oturan Degaje Yaka Midi Askılı Esnek Örme Midi Kalem Elbise TWOSS19AD0020,540,2022-03-13,2025-02-27,1082,518,22
TRENDYOLMİLLA Siyah Fitilli Kare Yaka Vücuda Oturan Uzun Kol Yırtmaçlı Midi Elbise TWOAW22EL0871,504,2022-04-15,2025-03-10,1060,451,53
TRENDYOLMİLLA Çok Renkli Çiçekli Eteği Volanlı Skater/Belden Açılan Şifon Mini Astarlı Dokuma Elbise TWOSS22EL2772,497,2022-05-05,2025-01-09,980,451,46
TRENDYOLMİLLA Siyah Tüvit A Kesim Mini Şifon Kol Detaylı Dokuma Elbise TWOAW21EL0532,487,2022-03-13,2025-03-09,1092,403,84
Trendyol Curve Siyah Dokuma Yırtmaçlı Elbise TBBSS22AH0012,486,2022-03-31,2025-03-10,1075,443,43
TRENDYOLMİLLA Turuncu Baskıılı Vücuda Oturan Midi Tek Omuz Ayarlanabilir Askılı Örme Kalem Elbise TWOSS23EL01577,472,2023-04-03,2025-03-10,707,408,64
TRENDYOLMİLLA Mor Fitted/ Vücuda Oturan Kolsuz Drape Detaylı Kemerli Midi Esnek Örme Kalem Elbise TWOSS22EL0756,466,2022-03-22,2025-03-07,1081,447,19
TRENDYOLMİLLA Siyah Belden AçılanMidi Kruvaze Piliseli Ayarlanabilir Askılı Esnek Örme Elbise TWOSS20EL2729,461,2022-03-17,2024-10-06,934,435,26
TRENDYOLMİLLA Siyah Fitted/Vücuda Oturan Büzgü Detaylı Midi Esnek Örme Kalem Elbise TWOSS23EL00751,456,2023-03-24,2025-03-09,716,422,34
TRENDYOLMİLLA Petrol Vücuda Oturan Dik Yaka Midi Kalem Etek Dokuma Elbise TWOAW20EL0311,446,2022-03-22,2025-03-07,1081,405,41
TRENDYOLMİLLA Siyah Vücuda Oturan Yırtmaçlı Bisiklet Yaka Midi Fitilli Esnek Örme Kalem Elbise TWOAW21EL0135,445,2022-04-04,2025-03-06,1067,398,47
TRENDYOLMİLLA Siyah Vücuda Oturan Mini Bisiklet Yaka Fitilli Esnek Örme Kalem Elbise TWOSS19AD0053,440,2022-03-18,2025-03-10,1088,405,35
TRENDYOLMİLLA Ekru Düğme Detaylı Gabardin Mini Dokuma Gömlek Elbise TWOSS22EL2970,433,2022-03-29,2025-03-04,1071,371,62
TRENDYOLMİLLA Çok Renkli Fırfır Detaylı Tül Örme Elbise,422,2022-04-01,2025-03-06,1070,400,22
TRENDYOLMİLLA Siyah Astarlı Dokuma Saten Şık Abiye Elbise TPRSS19BB0058,414,2022-04-19,2025-03-10,1056,322,92
TRENDYOLMİLLA Siyah Vücuda Oturan Dik Yaka Midi Kalem Etek Dokuma Elbise TWOAW20EL0311,414,2022-04-23,2025-03-04,1046,367,47
TRENDYOLMİLLA Kahverengi Vücuda Oturan Degaje Yaka Midi Esnek Örme Kalem Elbise TWOSS19AD0020,411,2022-04-14,2025-03-10,1061,376,35
TRENDYOLMİLLA Siyah Geniş Kesim Mini Dokuma Elbise TWOSS20EL0400,410,2022-03-19,2024-11-17,974,336,74
TRENDYOLMİLLA Siyah Vücuda Oturan Düğme Detaylı Yırtmaçlı Midi Kalem Etek Dokuma Elbise TWOSS23EL02256,410,2023-04-01,2025-03-10,709,367,43
TRENDYOLMİLLA Siyah Halter Yaka A Kesim Mini Dokuma Elbise TWOSS21EL1538,400,2022-04-05,2025-03-10,1070,346,54
TRENDYOLMİLLA Kiremit Çiçek Desenli A Kesim Volanlı Astarlı Midi Dokuma Elbise TWOSS20EL0894,400,2022-04-15,2025-03-10,1060,368,32
TRENDYOLMİLLA Siyah Dik Yaka Dokuma Elbise TCLAW19LJ0076,398,2022-03-15,2025-01-25,1047,364,34
TRENDYOLMİLLA Siyah Fitted/Vücuda Oturan Askılı Maxi Esnek Örme Kalem Elbise TWOSS23EL02435,384,2023-07-13,2025-03-10,606,360,24
TRENDYOLMİLLA Bridal Ekru Vücuda Oturan Korse Detaylı Dokuma Şık Abiye Elbise TPRSS22EL00097,379,2022-04-11,2025-03-09,1063,336,43
Trendyol Curve Siyah Büyük Beden Astarsız Truvakar Kol Mini Dokuma Ceket Elbise TBBAW23AH00042,378,2022-08-26,2025-03-08,925,345,33
TRENDYOLMİLLA Fuşya Kuşaklı Mini Dokuma Ceket Dokuma Elbise TWOSS20EL0236,375,2022-04-06,2024-10-20,928,341,34
Trendyol Curve Siyah Puantiyeli A-line Mini Örme Elbise Büyük Beden Elbise TBBAW23AH00003,374,2022-10-07,2025-03-10,885,350,24
TRENDYOLMİLLA Siyah A Kesim Gömlek Yaka Tüvit Mini Dokuma Elbise TWOAW23EL00701,371,2022-09-10,2025-03-10,912,309,62
TRENDYOLMİLLA Çok Renkli A Kesim Dik Yaka Çiçek Desenli Süper Mini Astarlı Dokuma Elbise TWOSS21EL2880,363,2022-03-23,2025-03-02,1075,324,39
TRENDYOLMİLLA Siyah Vücuda Oturan Astarlı Parlak Taşlı Dokuma Şık Abiye Elbise TPRSS23EL00476,355,2023-03-24,2025-03-10,717,312,43
TRENDYOLMİLLA Siyah Kısa Kol Fitted/Vücuda Oturan Pamuklu Esnek Midi Örme Kalem Elbise TWOSS23EL00313,351,2023-04-02,2024-10-26,573,318,33
TRENDYOLMİLLA Ekru Çiçek Desenli A-Kesim Fırfır Detaylı Astarlı Şifon Maxi Dokuma Elbise TWOSS23EL02013,349,2023-04-08,2025-03-10,702,306,43
TRENDYOLMİLLA Çok Renkli Batik Desenli Düz Kesim Kolsuz Maxi Astarlı Saten Dokuma Elbise TWOSS23EL02238,346,2023-04-01,2025-03-01,700,310,36
TRENDYOLMİLLA Siyah A-Kesim Astarlı Volanlı Dokuma Şifon Kısa Şık Abiye Elbise TPRSS23EL00096,343,2023-03-02,2025-02-25,726,302,41
TRENDYOLMİLLA Siyah Kuşaklı Kruvaze Dokuma Elbise TWOAW20EL0789,342,2022-03-23,2025-03-10,1083,303,39
TRENDYOLMİLLA Bordo Vücuda Oturan Dik Yaka Midi Kalem Etek Dokuma Elbise TWOAW20EL0311,339,2022-03-12,2025-02-06,1062,300,39
TRENDYOLMİLLA Bej Mini Triko Dantelli Elbise TWOAW22EL0011,338,2022-04-13,2025-03-04,1056,305,33
TRENDYOLMİLLA Siyah Vücuda Oturan Asimetrik Yaka Omzu Açık Mini Fitilli Esnek Örme Kalem Elbise TWOAW23EL00118,335,2022-10-26,2025-03-10,866,292,43
TRENDYOLMİLLA Siyah Bağlama Detaylı Bisiklet Yaka Triko Görünümlü Mini Örme Elbise TWOSS22EL0751,334,2022-03-13,2024-09-18,920,284,50
TRENDYOLMİLLA Siyah Dokuma Elbise,331,2022-04-04,2025-02-19,1052,299,32
TRENDYOLMİLLA Siyah Fitted/Vücuda Oturan Büzgü ve Yırtmaç Detaylı Midi Pamuklu Esnek Örme Elbise TWOSS23EL00777,328,2023-05-06,2025-03-11,675,284,44
TRENDYOLMİLLA Siyah Astarlı Volanlı Dokuma Şık Abiye Elbise TPRAW19BB0144,328,2022-03-23,2025-03-09,1082,292,36
TRENDYOLMİLLA Ekru Kuşaklı Midi Düğmeli Kare Yaka Dokuma Keten Görünümlü Elbise TWOSS19IE0009,326,2022-03-15,2024-09-05,905,261,65
TRENDYOLMİLLA Pembe Kemer Detaylı Triko Midi Elbise TWOSS22EL1031,325,2022-04-03,2025-03-11,1073,291,34
TRENDYOLMİLLA Siyah Limited Edition Vücuda Oturan Drape Detaylı Mini Gabardin Dokuma Elbise TWOAW21EL1388,322,2022-03-16,2024-11-13,973,271,51
Trendyol Curve Siyah Dokuma Kolları Volanlı Elbise TBBSS22EL1626,315,2022-04-04,2025-03-10,1071,266,49
TRENDYOLMİLLA Beyaz Dokuma %100 Pamuk Brode Detaylı Mini Plaj Elbisesi TBESS21EL1248,311,2022-04-02,2024-08-20,871,298,13
TRENDYOLMİLLA Siyah Büzgü Detaylı Vücuda Oturan Mini Kare Yaka Fitilli Esnek Örme Kalem Elbise TWOAW23EL01396,310,2022-09-17,2025-03-09,904,276,34
TRENDYOLMİLLA Lacivert Shift/Düz Havuz Yaka Midi Triko Görünümlü Esnek Örme Elbise TWOSS22EL2964,308,2022-04-27,2025-03-09,1047,274,34
TRENDYOLMİLLA Siyah Kemerli A Kesim Astarlı Midi Dokuma Elbise TWOSS20EL0983,304,2022-04-18,2025-03-11,1058,262,42
TRENDYOLMİLLA Kiremit Çiçekli A Kesim Fırfırlı Astarlı Mini Dokuma Elbise TWOSS20EL0681,303,2022-04-12,2024-10-03,905,270,33
TRENDYOLMİLLA Turuncu Etnik Desenli Belden Açılan Şifon Astarlı Mini Dokuma Elbise TWOSS23EL00519,302,2023-01-12,2025-03-10,788,276,26
TRENDYOLMİLLA Çok Renkli A Kesim Astarlı Pencere/Cut Out Detaylı Çiçek Desenli Maxi Dokuma Elbise TWOSS20EL1270,300,2022-03-12,2025-03-10,1094,252,48
TRENDYOLMİLLA Çiçek Desenli Maxi Dokuma Volanlı Plaj Elbisesi TBESS19WY0004,298,2022-03-22,2025-03-05,1079,268,30
Trendyol Curve Siyah Kruvaze Yaka Askılı Örme Elbise TBBSS22EL1565,290,2022-03-21,2025-02-03,1050,282,8
TRENDYOLMİLLA Haki A-Kesim Mini Pamuklu Pencere/Cut Out Detaylı Detaylı Kare Yaka Dokuma Elbise TWOSS23EL00596,290,2023-04-04,2024-10-17,562,235,55
TRENDYOLMİLLA Pembe Vücuda Oturan Midi Triko Hırka Elbise Takım TWOSS21EL0208,289,2022-03-14,2025-03-07,1089,266,23
TRENDYOLMİLLA Kahverengi Vücuda Oturan Yırtmaçlı Bisiklet Yaka Midi Fitilli Esnek Örme Elbise TWOAW21EL0135,288,2022-08-12,2025-01-16,888,273,15
TRENDYOLMİLLA Siyah Kuşaklı Bağlamalı Örme Maxi Plaj Elbisesi TBESS21EL2992,288,2022-03-18,2025-03-08,1086,258,30
TRENDYOLMİLLA Ekru Vücuda Oturan Dik Yaka Midi Kalem Etek Dokuma Elbise TWOAW20EL0311,286,2022-04-07,2024-09-26,903,249,37
TRENDYOLMİLLA Siyah A Kesim Dik Yaka Eteği Büzgülü Mini Dokuma Elbise TWOAW21EL1816,286,2022-03-13,2025-02-09,1064,256,30
TRENDYOLMİLLA Bridal Ekru A-Kesim Astarlı Volanlı Dokuma Şifon Kısa Düğün/Nikah Şık Abiye Elbise TPRSS23EL00096,283,2023-05-03,2025-03-07,674,242,41
TRENDYOLMİLLA Siyah Kuşaklı Mini Dokuma Ceket Dokuma Elbise TWOSS20EL0236,283,2022-03-22,2024-12-21,1005,239,44
TRENDYOLMİLLA Haki Bağlama Detaylı Dokuma Elbise TWOAW20EL1156,282,2022-03-12,2025-03-10,1094,245,37
Trendyol Curve Gipe ve Düğme Detaylı Dokuma Elbise,282,2022-03-18,2024-12-09,997,259,23
TRENDYOLMİLLA Mavi Denim Elbise,282,2022-03-12,2025-03-10,1094,234,48
TRENDYOLMİLLA Beyaz Dokuma %100 Pamuk Mini Plaj Elbisesi TBESS21EL3979,281,2022-03-17,2025-02-21,1072,242,39
TRENDYOLMİLLA Yağ Yeşil Vücuda Oturan Astarlı Korse Detaylı Örme Kısa Abiye Gece Elbise TPRSS23EL00174,278,2023-03-17,2025-03-09,723,219,59
TRENDYOLMİLLA Kırmızı Vücuda Oturan Dik Yaka Midi Kalem Etek Dokuma Elbise TWOAW20EL0311,278,2022-03-15,2025-01-13,1035,251,27
TRENDYOLMİLLA Fuşya Animal Desenli A Kesim Melek Kol Astarlı Şifon Midi Dokuma Elbise TWOSS23EL01372,275,2023-04-04,2025-03-01,697,239,36
TRENDYOLMİLLA Lacivert Çiçek Desenli Kare Yaka A Kesim Viskon Midi Dokuma Elbise TWOSS20EL3331,273,2022-03-19,2025-02-06,1055,231,42
TRENDYOLMİLLA Siyah Balıkçı Yaka Shift/Düz Mini Selanik Uzun Kollu Örme Elbise TWOAW20EL1110,273,2022-03-13,2025-01-29,1053,253,20
TRENDYOLMİLLA Siyah %100 Pamuk Bele Oturan Yırtmaç ve Bağlama Detaylı Midi Örme Kalem Elbise TWOSS21EL0404,272,2022-03-25,2024-12-14,995,234,38
TRENDYOLMİLLA Zümrüt Yeşili Vücuda Oturan Kolsuz Drape Detaylı Kemerli Midi Esnek Örme Kalem Elbise TWOSS22EL0756,271,2023-01-25,2025-03-04,769,250,21
TRENDYOLMİLLA Lacivert Vücuda Oturan Midi Triko Hırka Elbise Takım TWOSS21EL0208,271,2022-03-12,2025-02-03,1059,243,28
TRENDYOLMİLLA Mor Askılı Fitted/Vücuda Oturan Kare Yaka Tül Midi Esnek Örme Kalem Elbise TWOSS22EL00726,270,2022-04-27,2025-03-10,1048,259,11
TRENDYOLMİLLA Siyah Eteği Volanlı A Kesim Şifon Midi Astarlı Dokuma Elbise TWOSS22EL00733,269,2022-05-07,2024-08-07,823,240,29
Trendyol Curve Siyah Çiçek Desenli A-line Maxi Boy Örme Büyük Beden Elbise TBBSS22AH00009,267,2022-04-29,2025-03-04,1040,250,17
TRENDYOLMİLLA Siyah Taş Detaylı Skater/Belden Açılan Kısa Kollu Mini Örme Kalem Elbise TWOAW24EL00395,264,2023-09-07,2025-03-10,550,257,7
TRENDYOLMİLLA Beyaz Skater/Belden Açılan Brode Mini Astarlı Dokuma Elbise TWOSS21EL3680,263,2022-03-16,2024-10-18,947,200,63
TRENDYOLMİLLA Siyah Baskılı Fitted/Vücuda Oturan Tek Omuz Asimetrik Büzgü Detaylı Örme Kalem Elbise TWOSS23EL02182,261,2023-06-06,2024-11-12,525,239,22
Trendyol Curve Floral Desenli Kemerli Mini Dokuma Elbise TBBSS22EL00039,261,2022-04-17,2025-03-09,1057,228,33
TRENDYOLMİLLA Siyah Kemerli A Kesim Piliseli Maxi Astarlı Şifon Dokuma Elbise TWOAW24EL00471,256,2023-09-13,2025-03-10,544,237,19
Trendyol Curve Siyah Dokuma Volanlı Elbise TBBSS22EL1595,254,2022-03-18,2024-11-29,987,222,32
TRENDYOLMİLLA Saks Dokuma %100 Pamuk Şerit Aksesuarlı Mini Plaj Elbisesi TBESS22EL0703,249,2022-04-04,2024-09-15,895,209,40
TRENDYOLMİLLA Pudra Çiçek Desenli Kruvaze Fırfır Detaylı Askılı Midi Şifon Astarlı Dokuma Elbise TWOSS19EL0375,249,2022-05-01,2024-08-05,827,220,29
TRENDYOLMİLLA Siyah Tüvit Dokuma Elbise TWOAW21EL0454,248,2022-03-18,2025-03-01,1079,197,51
TRENDYOLMİLLA Taş Kuşaklı A Kesim Mini Kruvaze Yaka Dokuma Keten Görünümlü Elbise TWOSS19XN0008,248,2022-03-15,2024-11-14,975,189,59
TRENDYOLMİLLA Turuncu Vücuda Oturan Cut Out/Pencere Detaylı Örme Kısa Şık Elbise TPRSS23EL00154,247,2023-03-02,2025-03-09,738,207,40
TRENDYOLMİLLA Siyah Midi Triko Polo Yaka Elbise TWOAW22EL1376,246,2022-03-14,2025-02-18,1072,223,23
TRENDYOLMİLLA Pembe Çiçek Desenli Kuşaklı A Kesim Halter Yaka Kolsuz Midi Astarlı Dokuma Elbise TWOSS20EL2536,245,2022-03-15,2024-09-17,917,195,50
TRENDYOLMİLLA Siyah Vücuda Oturan Otrişli Parlak Taşlı Dokuma Kısa Şık Abiye Elbise TPRSS23EL00255,243,2023-05-25,2025-03-10,655,193,50
TRENDYOLMİLLA Siyah Düz Kesim Kolsuz Bisiklet Yaka Mini Dokuma Elbise TWOSS19FG0063,242,2022-03-18,2024-10-14,941,188,54
TRENDYOLMİLLA Siyah Düz Kesim Nakışlı Midi Dokuma Elbise TWOAW22EL0882,242,2022-03-15,2024-06-24,832,211,31
TRENDYOLMİLLA Yeşil Vücudu Saran Kuşgözü Detaylı Yırtmaçlı Kare Yaka Midi Kalem Etek Dokuma Elbise TWOSS19EL0079,239,2022-03-11,2025-01-30,1056,216,23
TRENDYOLMİLLA Mavi Cep Detaylı Mini Denim Gömlek Elbise TWOAW23EL00643,238,2022-09-22,2025-03-10,900,204,34
TRENDYOLMİLLA Kahverengi Zebra Desenli Skater/Belden Açılan Kruvaze Yaka Mini Esnek Örme Elbise TWOAW22EL0104,238,2022-09-08,2025-03-07,911,222,16
TRENDYOLMİLLA Mavi Çiçek Desenli Düz Kesim Halter Yaka Mini Astarlı Şifon Dokuma Elbise TWOSS23EL02293,235,2023-06-06,2025-03-09,642,210,25
TRENDYOLMİLLA Haki Kemerli Düğmeli Dokuma Ceket Elbise TWOAW22EL0446,235,2022-03-12,2025-03-05,1089,201,34
TRENDYOLMİLLA Siyah Volanlı Kare Yaka Fitted/Vücuda Oturan Maxi Esnek Örme Elbise TWOAW24EL00613,233,2023-09-26,2025-03-10,531,227,6
Trendyol Curve Çok Renkli A-line Çiçek Desenli V Yaka Örme Büyük Beden Elbise TBBSS22AH00010,231,2022-04-29,2025-03-10,1046,223,8
TRENDYOLMİLLA Saks Vücuda Oturan Astarlı Parıltılı Örme Kısa Şık Abiye Elbise TPRSS21EL2596,230,2022-03-25,2025-03-10,1081,189,41
TRENDYOLMİLLA Mavi Dikiş Detaylı Oversize Denim Elbise TWOAW22EL0072,229,2022-03-17,2025-03-10,1089,201,28
TRENDYOLMİLLA Limited Edition Mavi Düğme Detaylı Straplez Mini Denim Elbise TWOSS23EL01731,228,2023-05-24,2024-11-21,547,214,14
TRENDYOLMİLLA Kahverengi Midi Triko Polo Yaka Elbise TWOAW22EL1376,226,2022-03-17,2025-02-06,1057,204,22
Trendyol Curve Siyah Kemerli Drape ve Yırtmaçlı Örme Elbise TBBSS22AH00008,225,2022-04-16,2025-02-28,1049,194,31
TRENDYOLMİLLA Kahverengi Belden Açılan Üst Bedeni Gipeli Tek Omuz Midi Dokuma Elbise TWOSS23EL01830,225,2023-03-23,2025-03-10,718,206,19
TRENDYOLMİLLA Ekru A-Kesim Mini Pamuklu Pencere/Cut Out Detaylı Detaylı Kare Yaka Dokuma Elbise TWOSS23EL00596,225,2023-03-01,2024-11-19,629,180,45
TRENDYOLMİLLA Siyah A-Kesim Balen Detaylı Dokuma Kısa Abiye Gece Elbise TPRSS22EL00065,224,2022-05-05,2024-08-27,845,175,49
Trendyol Curve Siyah Düz Kesim Örme Elbise TBBSS22EL2365,223,2022-03-15,2024-08-06,875,200,23
TRENDYOLMİLLA Tarçın Dokuma Püsküllü Cut Out/Pencere Maxi Plaj Elbisesi TBESS21EL3624,222,2022-05-19,2024-08-29,833,186,36
TRENDYOLMİLLA Pembe A-Kesim Dokuma Kısa Abiye Gece Elbise TPRSS23EL00031,222,2023-04-07,2025-03-08,701,165,57
TRENDYOLMİLLA Mavi Çiçek Desenli Kuşaklı Midi Dokuma Viskon Gömlek Elbise TWOSS20EL1559,221,2022-03-19,2024-09-08,904,192,29
TRENDYOLMİLLA Siyah Puantiyeli Belden Açılan Volanlı Bisiklet Yaka Mini Dokuma Elbise TWOAW22EL0126,221,2022-03-13,2025-03-11,1094,196,25
TRENDYOLMİLLA Bridal Ekru Dokuma Abiye Gece Elbise TPRSS21EL0053,221,2022-04-12,2024-12-01,964,199,22
TRENDYOLMİLLA Lacivert Mini Triko Gömlek Garni Detaylı Elbise TWOAW22SV0122,221,2022-03-22,2025-01-17,1032,183,38
TRENDYOLMİLLA Siyah Kruvaze Yaka Cut Out/Pencere Detaylı Örme Şık Abiye Elbise TPRAW23EL00272,220,2022-09-12,2025-01-09,850,204,16
Trendyol Curve Siyah Düz Kesim Bağlama Detaylı Yırtmaçlı Maxi/Uzun %100 Pamuk Örme Büyük Beden Elbise TBBSS22EL1640,220,2022-03-17,2024-06-13,819,194,26
TRENDYOLMİLLA Siyah Düğme Detaylı Mini Dokuma Ceket Elbise TWOSS20EL0407,219,2022-03-14,2025-01-14,1037,182,37
TRENDYOLMİLLA Mor Vücuda Oturan Korse Detaylı Dokuma Şık Abiye Elbise TPRSS22EL00097,218,2023-04-27,2024-11-06,559,180,38
TRENDYOLMİLLA Kırmızı Vücuda Oturan Astarlı Dokuma Kısa Şık Abiye Elbise TPRAW19BB0007,217,2022-04-05,2025-03-04,1064,180,37
TRENDYOLMİLLA Siyah Ekose / Kareli V Yaka Mini Dokuma Jile Elbise TWOAW21EL0319,216,2022-03-14,2025-03-05,1087,142,74
TRENDYOLMİLLA Lacivert Belden Açılan Volanlı Dik Yaka Astarlı Midi Dokuma Kışlık Elbise TWOAW21EL0354,214,2022-03-12,2025-03-03,1087,188,26
TRENDYOLMİLLA Siyah Vücudu Saran Gömlek Yaka Mini Dokuma Elbise TWOAW23EL00611,214,2022-09-13,2025-02-04,875,184,30
TRENDYOLMİLLA Çok Renkli Boyundan Bağlamalı Dokuma Kışlık Elbise TWOAW21EL1448,209,2022-03-14,2025-03-09,1091,195,14
TRENDYOLMİLLA Siyah Düğme Detaylı Mini Dokuma Ceket Elbise TWOAW24EL00462,209,2023-09-27,2025-03-09,529,197,12
TRENDYOLMİLLA Siyah Dokuma %100 Pamuk Brode Detaylı Mini Plaj Elbisesi TBESS21EL1248,206,2022-03-21,2024-10-09,933,196,10
TRENDYOLMİLLA Kahverengi Fitted/Vücuda Oturan Askılı Maxi Esnek Örme Kalem Elbise TWOSS23EL02435,205,2023-09-27,2025-03-10,530,186,19
Trendyol Curve Siyah A-Line Dokuma Cep Detaylı Elbise TBBSS22EL1598,204,2022-03-22,2025-03-01,1075,173,31
TRENDYOLMİLLA Lacivert Kuşaklı Yırtmaçlı Çiçek Desenli Midi Dokuma Gömlek Elbise TWOSS20EL2822,201,2022-04-26,2024-11-13,932,167,34
Trendyol Curve Siyah Askılı A-Kesim/Çan Dantelli Uzun Abiye/Mezuniyet/Nişan/Gece Elbisesi TBBAW23AH00187,201,2022-11-07,2025-03-01,845,189,12
TRENDYOLMİLLA Siyah Tek Omuzlu Drapeli Fitted/Vücuda Oturan Esnek Örme Midi Kalem Elbise TWOSS24EL00100,201,2024-05-20,2025-03-10,294,169,32
TRENDYOLMİLLA Siyah Maxi Dokuma Büzgülü Sırt Dekolteli Plaj Elbisesi TBESS23EL00063,201,2023-06-07,2024-11-13,525,162,39
"Trendyol Curve Siyah Örme Drape Detaylı 
Maxi/Uzun Abiye Elbise TBBSS22AD00000",200,2022-07-06,2025-03-02,970,180,20
Trendyol Curve Siyah Düz Kruvaze Dokuma Elbise TBBSS23AH00254,200,2023-05-16,2024-12-15,579,170,30
TRENDYOLMİLLA Açık Mavi Cep Detaylı Oversize Mini Denim Gömlek Elbise TWOSS22EL3022,199,2022-04-15,2024-11-23,953,161,38
TRENDYOLMİLLA Lacivert Düğme Detaylı Gabardin Mini Dokuma Gömlek Elbise TWOSS22EL2970,198,2022-07-07,2024-09-06,792,165,33
TRENDYOLMİLLA Siyah Bodycone Sıfır Kol Yırtmaçlı Fırfır Detaylı Esnek Kalın Sandy Maxi Kalem Elbise TWOSS24EL00688,198,2024-03-31,2025-03-08,342,184,14
TRENDYOLMİLLA Camel Leopar Desenli Kruvaze Yırtmaç Detaylı Maxi Dokuma Elbise TWOSS23EL01892,196,2023-06-13,2024-09-01,446,190,6
TRENDYOLMİLLA Mint Düz Kesim Cepli Gömlek Yaka Keten Görünümlü Mini Dokuma Elbise TWOSS22EL1068,195,2022-03-15,2024-10-10,940,177,18
TRENDYOLMİLLA Beyaz A Kesim Yaka Detaylı Brode Mini Astarlı Dokuma Elbise TWOSS21EL2089,195,2022-04-07,2025-03-09,1067,170,25
TRENDYOLMİLLA Ekru Kruvaze Mini Dokuma Elbise TWOSS23EL00113,195,2023-01-25,2025-03-09,774,172,23
TRENDYOLMİLLA Siyah A-Kesim Dokuma Kısa Şık Abiye Elbise TPRSS23EL00031,195,2023-01-18,2024-10-30,651,156,39
TRENDYOLMİLLA Kırmızı Shift/Düz Kesim Dik Yaka Midi Dokuma Elbise TWOSS20EL1864,194,2022-06-13,2024-08-22,801,172,22
TRENDYOLMİLLA Siyah Krep Vücuda Oturan Askılı Cut Out Detaylı Volanlı Kalp Yaka Mini Örme Elbise TWOSS23EL02097,194,2023-04-28,2024-08-30,490,162,32
TRENDYOLMİLLA Siyah Kruvaze Yaka A-Line Krep Mini Smart Örme Elbise TWOSS23EL01703,194,2023-04-16,2025-03-10,694,145,49
TRENDYOLMİLLA Çiçek Desenli Mini Dokuma Cut Out/Pencere Plaj Elbisesi TBESS21EL1054,192,2022-03-26,2024-07-09,836,163,29
TRENDYOLMİLLA Sarı Çiçek Desenli A-Kesim Kat Kat Mini Astarlı Şifon Dokuma Elbise TWOSS23EL02056,192,2023-05-08,2024-11-24,566,174,18
TRENDYOLMİLLA Lacivert Düz Kesim Cepli Gömlek Yaka Keten Görünümlü Mini Dokuma Elbise TWOSS22EL1068,191,2022-03-21,2024-08-22,885,173,18
TRENDYOLMİLLA Yeşil Çizgili Maxi Örme Dokulu Aksesuarlı Plaj Elbisesi TBESS23EL00066,190,2023-04-13,2025-03-05,692,176,14
TRENDYOLMİLLA Siyah Vücuda Oturan Astarlı Korse Detaylı Örme Kısa Şık Abiye Elbise TPRSS23EL00174,190,2023-02-03,2024-11-23,659,154,36
TRENDYOLMİLLA Mor Düz Kesim Kolsuz Bisiklet Yaka Mini Dokuma Elbise TWOSS19FG0063,190,2022-03-12,2025-02-26,1082,156,34
TRENDYOLMİLLA Siyah Yumuşak Dokulu Midi Kruvaze Yaka Bağlama Detaylı Triko Elbise,190,2022-04-14,2024-12-20,981,157,33
TRENDYOLMİLLA Haki Kuşaklı Bağlamalı Örme Maxi Plaj Elbisesi TBESS21EL2992,189,2022-04-25,2024-08-14,842,168,21
TRENDYOLMİLLA Indigo Çiçek Baskılı Sıfır Kol Volanlı Shift/Düz Mini Esnek Örme Elbise TWOSS22EL0794,189,2023-03-30,2024-12-06,617,177,12
TRENDYOLMİLLA Siyah Vücuda Oturan Midi Triko Hırka Elbise Takım TWOSS21EL0208,189,2022-06-21,2025-02-13,968,174,15
TRENDYOLMİLLA Çok Renkli Cut Out/Pencere Detaylı Maxi Dokuma Elbise TWOSS21EL3578,188,2022-03-27,2024-12-19,998,163,25
TRENDYOLMİLLA Taş Midi Triko Kemer Detaylı Elbise TWOAW22EL0009,185,2022-05-04,2025-02-26,1029,171,14
TRENDYOLMİLLA Beyaz Astarlı Pencere/Cut Out Detaylı Puantiyeli Örme Tül Kısa Abiye Gece Elbise TPRSS19FZ0120,185,2022-03-15,2025-02-13,1066,168,17
TRENDYOLMİLLA Lacivert Midi Triko Kemer Detaylı Elbise TWOAW22EL0009,183,2022-04-08,2025-02-21,1050,167,16
TRENDYOLMİLLA Siyah Kısa Kol Bodycone/Vücuda Oturan Bisiklet Yaka Esnek Örme Maxi Kalem Elbise TWOSS24EL00097,179,2024-04-19,2025-01-28,284,168,11
Trendyol Curve Siyah Büyük Beden Kare Yaka Yırtmaçlı A-Kesim/Çan Midi Dokuma Şifon Elbise TBBAW23AH00107,178,2022-08-20,2025-02-15,910,161,17
TRENDYOLMİLLA Siyah Yumuşak Kumaşlı Fitted/Vücuda Oturan Kısa Kollu Esnek Örme Mini Kalem Elbise TWOSS24EL00756,177,2024-03-30,2025-03-10,345,144,33
TRENDYOLMİLLA Lacivert A Kesim Korsaj Detaylı V Yaka Maxi Dokuma Elbise TWOSS24EL00620,177,2024-04-15,2025-03-04,323,133,44
TRENDYOLMİLLA Çok Renkli Tek Kol Vücuda Oturan Aksesuar Detaylı Tül Esnek Örme Midi Kalem Elbise TWOSS24EL00174,176,2024-03-09,2025-02-23,351,169,7
TRENDYOLMİLLA Siyah Ayarlanabilir Askılı A-Line Bürümcük/Dokulu Örme Maxi Elbise TWOSS24EL00060,175,2024-05-02,2025-01-31,274,160,15
TRENDYOLMİLLA Haki Dokulu Kumaş Fitted/Vücuda Oturan Ay Kol Esnek Örme Midi Kalem Elbise TWOSS24EL00103,175,2024-02-23,2025-03-09,380,159,16
Trendyol Curve Siyah Dokuma Yırtmaçlı İnce Ayarlanabilir Askılı Abiye/Gece/Mezuniyet/Nişan Elbise TBBSS22AD00001,175,2022-07-15,2025-03-09,968,153,22
TRENDYOLMİLLA Siyah Bisiklet Yaka Taş Detaylı Shift/Düz Mini Süet Örme Elbise TWOAW24EL00523,175,2023-09-11,2025-03-09,545,162,13
TRENDYOLMİLLA Siyah Midi Triko Basic Carmen Yaka Elbise TWOAW25EL00033,175,2024-09-13,2025-03-10,178,156,19
TRENDYOLMİLLA Bordo A-Kesim Dokuma Şifon Kısa Şık Abiye Elbise TPRSS23EL00033,174,2023-03-20,2025-01-11,663,142,32
TRENDYOLMİLLA Beyaz Yumuşak Kumaşlı Fitted/Vücuda Oturan Kısa Kollu Esnek Örme Mini Kalem Elbise TWOSS24EL00756,174,2024-04-20,2025-01-30,285,157,17
TRENDYOLMİLLA Siyah Animal Shift Shally Maxi Dokuma Elbise TWOSS24EL00872,174,2024-05-11,2024-09-10,122,155,19
Trendyol Curve Siyah Kuşaklı Dokuma Düğmeli Midi Büyük Beden Gömlek Elbise TBBSS22AH0079,174,2022-03-19,2024-12-02,989,158,16
TRENDYOLMİLLA Bridal Ekru Vücuda Oturan Astarlı Dokuma Düğün/Nikah Şık Abiye Elbise TPRSS23EL00541,174,2023-04-27,2025-03-09,682,152,22
Trendyol Curve Siyah Ayarlanabilir Askılı Vücuda Oturan Midi/Orta Boy Dokuma Büyük Beden Elbise TBBSS22AH00039,174,2022-11-15,2025-01-31,808,136,38
TRENDYOLMİLLA Lacivert A-Kesim Beli Lastikli Denim Kısa Şık Elbise TPRAW23EL00420,174,2022-11-02,2025-03-10,859,118,56
TRENDYOLMİLLA Limited Edition Çok Renkli Çiçek Baskılı Örme Maxi Esnek Kalem Elbise TWOSS24EL00563,174,2024-04-18,2025-03-06,322,149,25
Trendyol Curve Siyah Yırtmaçlı Örme Elbise TBBSS23AH00280,173,2023-07-12,2025-03-10,607,145,28
Trendyol Curve Siyah Kuşaklı A-line Örme Elbise TBBSS22AH0176,173,2022-03-15,2025-02-16,1069,152,21
TRENDYOLMİLLA Beyaz Düz Dokulu A Kesim/Çan Form Bisiklet Yaka Dokulu Maxi Elbise TWOSS24EL00683,173,2024-03-16,2025-01-28,318,140,33
Trendyol Curve Siyah Beyaz Gömlek Yaka Uzun Kol Düğmeli Tüvit Elbise TBBAW24AH00026,173,2023-09-06,2025-03-10,551,154,19
Trendyol Curve Mavi A-line Kruvaze Yaka Çiçek Desenli Yazlık Örme Elbise TBBSS22AH00000,172,2022-04-19,2024-12-18,974,159,13
Trendyol Curve Koyu Kahverengi Polo Yaka Fitilli Triko Elbise TBBAW23AH00002,172,2022-08-15,2025-03-10,938,158,14
TRENDYOLMİLLA Siyah Düz Bodycone Straplez Detaylı Finike Mini Dokuma Gömlek Elbise TWOSS24EL00751,172,2024-02-16,2025-03-08,386,128,44
TRENDYOLMİLLA Kahverengi Bağlama Detaylı Dokuma Elbise TWOAW20EL1156,172,2022-03-12,2025-02-16,1072,153,19
TRENDYOLMİLLA Siyah Vatkalı Drapeli Fitted/Vücuda Oturan Mini Esnek Örme Kalem Elbise TWOAW24EL00821,172,2023-10-04,2025-03-08,521,154,18
TRENDYOLMİLLA Siyah Sırt Dekolteli Eteği Volanlı Dik Yaka Maxi Boy Esnek Örme Elbise TWOAW24EL00380,172,2023-09-22,2025-03-10,535,160,12
TRENDYOLMİLLA Açık Yeşil Asimetrik Pilise Detaylı Örme Saten Şık Abiye Elbise TPRSS23EL00557,172,2023-04-10,2025-03-08,698,140,32
Trendyol Curve Bordo Dokuma Yırtmaçlı Elbise TBBSS22AH0012,171,2023-01-02,2025-02-08,768,148,23
Trendyol Curve Fuşya Kare Yaka Balon Kollu Dokuma Yırtmaçlı Astarlı Şifon Elbise TBBSS22AH0012,171,2022-04-25,2024-09-12,871,148,23
TRENDYOLMİLLA Siyah A-Kesim Fiyonk Detaylı Dokuma Şık Abiye Elbise TPRSS24EL00105,171,2024-03-21,2024-11-17,241,148,23
TRENDYOLMİLLA Kırmızı Çiçekli Viskon Maxi Dokuma Elbise TWOSS24EL00613,171,2024-03-02,2025-02-25,360,140,31
TRENDYOLMİLLA Leopar Desenli Maxi Dokuma Yırtmaçlı Plaj Elbisesi TBESS22EL0731,171,2022-03-17,2025-03-03,1082,156,15
TRENDYOLMİLLA Lacivert Fitted/Vücuda Oturan Askılı Esnek Maxi Örme Kalem Elbise TWOSS23EL02435,171,2023-10-05,2024-10-27,388,156,15
TRENDYOLMİLLA Mavi Desenli Drapeli Vücuda Oturan Esnek Maxi Tül Kalem Elbise TWOSS23EL01799,171,2023-03-30,2025-03-10,711,148,23
TRENDYOLMİLLA Haki Maxi Dokuma Sırt Dekolteli Keten Karışımlı Plaj Elbisesi TBESS24EL00096,170,2024-05-09,2025-03-07,302,147,23
TRENDYOLMİLLA Siyah A-Kesim Astarlı Dokuma Şifon Kısa Abiye Gece Elbise TPRSS23EL00033,170,2023-03-23,2025-03-01,709,150,20
Trendyol Curve Kırmızı Büyük Beden Astarsız Truvakar Kol Mini/Kısa Boy Dokuma Ceket Elbise TBBAW23AH00042,170,2022-11-02,2025-03-10,859,138,32
TRENDYOLMİLLA Siyah Kayık Yaka Sırt Dekolteli Yırtmaçlı Fitted/Vücuda Oturan Maxi Esnek Örme Elbise TWOAW24EL00824,170,2023-10-02,2025-03-10,525,145,25
TRENDYOLMİLLA Limited Edition Koyu Mavi Düğme Detaylı Halter Yaka Mini Denim Elbise TWOSS23EL01730,170,2023-03-27,2025-02-15,691,149,21
Trendyol Curve Siyah Polo Yaka Fitilli Triko Elbise TBBAW23AH00002,170,2022-10-29,2025-03-10,863,157,13
TRENDYOLMİLLA Kırmızı Vücuda Oturan Korse Detaylı Dokuma Şık Abiye Elbise TPRSS22EL00097,170,2022-10-06,2025-01-18,835,141,29
TRENDYOLMİLLA Ekru Mini Dokuma Bağlamalı Keten Karışımlı Plaj Elbisesi TBESS23EL00103,170,2023-02-24,2025-01-09,685,135,35
Trendyol Curve Mavi Kare Yaka Balon Kollu Dokuma Yırtmaçlı Astarlı Şifon Elbise TBBSS22AH0012,169,2022-05-24,2025-02-05,988,150,19
TRENDYOLMİLLA Mavi Kuşaklı A Kesim Çizgili Mini Dokuma Elbise TWOSS21EL1290,169,2022-04-05,2024-07-31,848,146,23
Trendyol Curve Kırmızı Puantiye Desenli Dokuma Elbise TBBSS22EL1712,169,2022-04-28,2025-02-26,1035,144,25
TRENDYOLMİLLA Siyah Mini Triko Pileli Etek Detaylı Elbise TWOAW24EL00013,169,2023-08-15,2025-03-06,569,139,30
Trendyol Curve Lacivert Dokuma Yakası Detaylı Elbise TBBSS22AH0246,169,2022-03-25,2025-02-18,1061,141,28
TRENDYOLMİLLA Siyah A-Kesim Astarlı Korse Detaylı Biyeli Dokuma Kısa Şık Abiye Elbise TPRSS23EL00251,168,2023-03-07,2025-03-02,726,131,37
TRENDYOLMİLLA Taş Midi Triko Basic Hırkalı Elbise TWOSS23EL00738,168,2023-01-17,2025-02-21,766,134,34
TRENDYOLMİLLA Premium Kahverengi Desenli Fitted/Vücuda Oturan Midi Esnek Örme Elbise TWOSS23EL01110,168,2023-03-23,2025-03-10,718,155,13
TRENDYOLMİLLA Çok Renkli Eteği Volanlı Düğme Detaylı Tüvit Dokuma Elbise TWOAW23EL00870,168,2022-09-30,2025-03-06,888,119,49
TRENDYOLMİLLA Limited Edition Siyah Fitted/Vücuda Oturan Örme Maxi Esnek Kalem Elbise TWOSS24EL00563,168,2024-04-29,2025-03-08,313,157,11
Trendyol Curve Fuşya Kruvaze Yaka Askılı Örme Elbise TBBSS22EL1565,168,2022-04-29,2024-11-27,943,159,9
TRENDYOLMİLLA Antrasit Maxi Triko V Yaka Jile Elbise TWOAW24EL00011,168,2023-08-14,2025-03-01,565,151,17
TRENDYOLMİLLA Turuncu Maxi Örme Boncuk Aksesuarlı Plaj Elbisesi TBESS21EL2796,168,2022-03-12,2024-10-14,947,154,14
TRENDYOLMİLLA Antrasit Askılı Mini Dokuma Jile Elbise TWOAW21EL1163,168,2022-04-07,2025-02-11,1041,116,52
TRENDYOLMİLLA Siyah Cut Out Detaylı Bodycone/Vücuda Oturan Dik Yaka Örme Kalem Elbise TWOSS23EL02166,168,2023-04-20,2025-03-10,690,143,25
TRENDYOLMİLLA Limited Edition Pembe Kareli Midi Dokuma Ceket Elbise TWOSS21EL3581,168,2022-03-24,2024-10-17,938,143,25
TRENDYOLMİLLA Siyah Vücuda Oturan Agraflı Örme Şık Abiye Elbise TPRSS23EL00084,168,2023-03-19,2025-01-04,657,149,19
TRENDYOLMİLLA Fuşya Vücuda Oturan Drapeli Dokuma Kısa Şık Abiye Elbise TPRAW24EL00083,167,2023-09-09,2025-03-05,543,133,34
TRENDYOLMİLLA Siyah A Kesim Dik Yaka Astarlı Şifon Mini Dokuma Elbise TWOAW24EL00296,167,2023-09-05,2025-02-07,521,134,33
Trendyol Curve Siyah Vücuda Oturan Büzgü Detaylı Örme Elbise TBBAW23AH00185,167,2022-10-29,2025-02-10,835,148,19
TRENDYOLMİLLA Gri Vücuda Oturan Astarlı Parıltılı Örme Payet Kısa Şık Abiye Elbise TPRSS22EL2889,167,2022-12-15,2024-12-15,731,141,26
TRENDYOLMİLLA Fuşya Belden Açılan Pileli Midi Dokuma Elbise TWOSS20EL0980,167,2022-03-13,2024-11-24,987,149,18
TRENDYOLMİLLA Yeşil Şal Desenli Volanlı Dokuma Kışlık Elbise TWOAW23EL01436,167,2022-10-14,2025-02-03,843,149,18
TRENDYOLMİLLA Mor Çiçek Desenli A Kesim Carmen Yaka Form Midi Dokuma Elbise TWOSS23EL01243,167,2023-04-03,2024-10-09,555,137,30
TRENDYOLMİLLA Kahverengi V Yaka Jile Süet Mini Örme Elbise TWOAW24EL00543,167,2023-09-12,2025-02-20,527,149,18
TRENDYOLMİLLA Kahverengi Midi Triko Bisiklet Yaka Elbise TWOAW21EL0422,167,2022-03-21,2025-02-20,1067,151,16
Trendyol Curve Lacivert Çiçek Desenli Dokuma Yırtmaç Detaylı Elbise TBBSS22EL1612,167,2022-05-14,2025-03-01,1022,154,13
TRENDYOLMİLLA Beyaz Brode Skater/Belden Açılan Mini Astarlı Dokuma Elbise TWOSS22EL00697,167,2022-05-05,2024-11-19,929,146,21
TRENDYOLMİLLA Siyah Vücuda Oturan Vatkalı Düğme Detaylı Mini Dokuma Elbise TWOAW24EL00483,167,2023-09-06,2025-02-18,531,148,19
Trendyol Curve Siyah Bisiklet Yaka Yırtmaçlı Maxi/Uzun %100 Pamuk Örme Elbise TBBSS23AH00159,167,2023-03-19,2024-08-08,508,143,24
TRENDYOLMİLLA Mavi Vücuda Oturan Astarlı Parıltılı Örme Kısa Şık Abiye Elbise TPRSS23EL00425,167,2023-03-22,2025-02-14,695,139,28
TRENDYOLMİLLA Siyah Vücuda Oturan Drapeli Dokuma Kısa Şık Abiye Elbise TPRAW24EL00083,166,2023-09-11,2025-03-09,545,140,26
TRENDYOLMİLLA Kahverengi Kuşaklı Dantel Detaylı Mini Dokuma Gömlek Elbise TWOAW21EL1964,166,2022-03-12,2025-03-06,1090,135,31
TRENDYOLMİLLA Çok Renkli Çiçek Desenli Dokuma Saten Şık Abiye Elbise TPRSS23EL00305,166,2023-01-18,2025-03-05,777,145,21
TRENDYOLMİLLA Siyah Kemerli Midi Dokuma Gömlek Elbise TWOAW21EL1428,166,2022-03-14,2024-12-12,1004,144,22
TRENDYOLMİLLA Yeşil Rahat Kesim V Yaka Midi Dokuma Elbise TWOSS23EL00882,166,2023-03-17,2024-10-24,587,139,27
TRENDYOLMİLLA Çok Renkli Çiçek Desenli Belden Açılan Mini Astarlı Şifon Dokuma Elbise TWOAW24EL00841,166,2023-08-11,2025-03-04,571,128,38
TRENDYOLMİLLA Çok Renkli Çiçek Desenli Kare Yaka A Kesim Viskon Midi Dokuma Elbise TWOSS20EL3331,166,2022-03-26,2024-09-11,900,140,26
Trendyol Curve Zümrüt Yeşili Örme Drape Detaylı Maxi/Uzun Abiye Elbise TBBSS22AD00000,165,2022-07-14,2025-01-30,931,151,14
TRENDYOLMİLLA Beyaz Dokuma Şerit Aksesuarlı Mini Plaj Elbisesi TBESS21EL2759,165,2022-03-18,2024-09-08,905,145,20
TRENDYOLMİLLA Haki Askılı Mini Dokuma Jile Elbise TWOAW21EL1163,165,2022-03-14,2025-03-09,1091,140,25
TRENDYOLMİLLA Mavi Çiçek Desenli A Kesim Volanlı Astarlı Midi Dokuma Elbise TWOSS20EL0894,165,2023-04-08,2024-12-16,618,138,27
TRENDYOLMİLLA Kırmızı Kare Yaka Mini Dokuma Elbise TWOAW23EL00894,165,2022-09-27,2025-01-04,830,120,45
TRENDYOLMİLLA Kırmızı Düğme Detaylı Mini Dokuma Ceket Elbise TWOAW24EL00462,165,2023-09-20,2025-03-10,537,137,28
TRENDYOLMİLLA Ekru Çiçek Desenli Kuşaklı A Kesim Halter Yaka Kolsuz Midi Astarlı Dokuma Elbise TWOSS20EL2536,165,2023-03-11,2025-03-10,730,155,10
Trendyol Curve Siyah Puantiyeli Kuşaklı Dokuma Elbise TBBSS22EL1596,165,2022-03-14,2025-02-11,1065,154,11
TRENDYOLMİLLA Siyah Vücuda Oturan Astarlı Parıltılı Pullu Örme Payet Şık Abiye Elbise TPRAW24EL00233,164,2023-09-28,2025-02-02,493,136,28
TRENDYOLMİLLA Siyah A Kesim Ceket Yaka Mini Dokuma Elbise TWOAW23EL00384,164,2022-08-30,2025-03-10,923,132,32
TRENDYOLMİLLA Siyah Drapeli V Yaka Fitted/Vücuda Oturan Esnek Midi Örme Kalem Elbise TWOAW24EL00197,164,2023-08-16,2025-01-22,525,142,22
TRENDYOLMİLLA Siyah Eteği Volanlı Kayık Kaya Maxi Esnek Örme Elbise TWOAW24EL00616,163,2023-09-28,2024-11-27,426,155,8
TRENDYOLMİLLA Lacivert Mini Triko Dantelli Elbise TWOAW22EL0011,163,2022-07-05,2025-01-17,927,150,13
TRENDYOLMİLLA Siyah Kemerli Mini Dokuma Ceket Elbise TWOAW22EL0243,163,2022-03-14,2025-01-25,1048,129,34
TRENDYOLMİLLA X Sagaza Studio Ekru Bel Lastik Detaylı Brode Elbise TPRSS22EL00083,162,2022-06-06,2025-02-25,995,137,25
TRENDYOLMİLLA Siyah Dokuma Püsküllü Cut Out/Pencere Maxi Plaj Elbisesi TBESS21EL3624,162,2022-03-19,2025-03-09,1086,137,25
TRENDYOLMİLLA Kahverengi Dik Yaka Fitted/Vücuda Oturan Maxi Esnek Örme Kalem Elbise TWOAW24EL00614,162,2023-09-28,2025-03-10,529,141,21
TRENDYOLMİLLA Siyah Taş Baskılı Straplez Dokuma Kısa Şık Abiye Elbise TPRSS23EL00577,162,2023-06-02,2025-01-02,580,134,28
TRENDYOLMİLLA Ekru Mini Dokuma Ekose Desenli Jile Elbise TWOAW20EL0208,162,2022-03-14,2025-03-02,1084,138,24
TRENDYOLMİLLA Siyah Fitilli Derin Yırtmaç Detaylı Fitted/Vücuda Oturan Midi Esnek Örme Elbise TWOAW24EL00174,162,2023-08-26,2025-03-11,563,141,21
TRENDYOLMİLLA Mavi Mini Astarlı Dik Yaka Dokuma Elbise TCLAW19LJ0076,161,2022-09-20,2025-03-07,899,147,14
TRENDYOLMİLLA Siyah V Yaka Dokuma Elbise TWOAW22EL0682,161,2022-03-12,2024-10-30,963,147,14
TRENDYOLMİLLA Bridal Ekru Vücuda Oturan Dokulu Astarlı Dokuma Kısa Düğün/Nikah Şık Abiye Elbise TPRSS23EL00024,161,2023-04-02,2024-11-22,600,135,26
TRENDYOLMİLLA Soyut Desenli Vücuda Oturan Mini Örme Büzgülü Transparan Plaj Elbisesi TBESS22EL0702,161,2022-04-23,2025-03-02,1044,144,17
TRENDYOLMİLLA Ekru Çiçek Desenli Belden Açılan V Yaka Mini Astarlı Şifon Dokuma Elbise TWOSS23EL01782,161,2023-03-22,2025-03-08,717,130,31
Trendyol Curve Indigo Kuşaklı Dokuma Elbise TBBSS22EL1670,161,2022-03-16,2025-02-25,1077,137,24
TRENDYOLMİLLA Çok Renkli Yaka Detaylı Dokuma Elbise TWOAW22EL0118,160,2022-03-19,2025-02-22,1071,148,12
Trendyol Curve Siyah Büyük Beden Astarsız Uzun Kollu A-Kesim Mini Dokuma Elbise TBBAW23AH00035,160,2022-11-04,2025-03-05,852,136,24
TRENDYOLMİLLA Bordo Kruvaze Yaka Cut Out/Pencere Detaylı Örme Şık Abiye Elbise TPRAW23EL00272,159,2022-09-21,2025-03-11,902,147,12
TRENDYOLMİLLA Siyah Mini Triko Geniş Kalıp Elbise TWOAW23EL00026,159,2022-09-23,2024-12-10,809,141,18
TRENDYOLMİLLA Mavi Vücuda Oturan Midi Triko Hırka Elbise Takım TWOSS21EL0208,159,2022-09-14,2025-02-28,898,152,7
TRENDYOLMİLLA Çok Renkli Desenli A-Kesim Askılı Midi Astarlı Dokuma Elbise TWOSS23EL00989,158,2023-04-28,2025-03-10,682,122,36
TRENDYOLMİLLA Siyah Düğme Detaylı Kolsuz Dokuma Mini Ceket Elbise TWOSS19AP0280,158,2022-03-21,2025-03-11,1086,127,31
TRENDYOLMİLLA Siyah Vücuda Oturan Kemerli Cep Detaylı Mini Elbise TWOSS23EL02037,158,2023-04-06,2024-11-10,584,134,24
TRENDYOLMİLLA Kırmızı Vücuda Oturan Bisiklet Yaka Mini Fitilli Esnek Örme Kalem Elbise TWOSS22EL2819,157,2023-03-31,2024-07-15,472,136,21
TRENDYOLMİLLA Haki Gömlek Yaka Dokuma Elbise TWOAW21EL1964,156,2022-03-13,2025-02-21,1076,120,36
TRENDYOLMİLLA Plaj Giyim Geometrik Desenli Dokuma %100 Pamuk Balon Kollu Mini Elbise TBESS21EL2771,156,2022-03-17,2024-11-13,972,135,21
TRENDYOLMİLLA Bordo Dik Yaka Dokuma Elbise TCLAW19LJ0076,154,2022-09-23,2025-02-11,872,136,18
TRENDYOLMİLLA Siyah Maxi Triko V Yaka Jile Elbise TWOAW24EL00011,125,2023-11-13,2025-02-28,473,114,11
Trendyol Curve Siyah Finike Dokuma Büyük Beden Elbise,119,2024-02-14,2025-03-09,389,104,15
TRENDYOLMİLLA Siyah Sıfır Kol Drapeli Bodycone/Vücuda Oturan Esnek Örme Maxi Kalem Elbise TWOSS24EL00101,119,2024-01-27,2025-03-10,408,112,7
Trendyol Curve Siyah Çıtır Çiçekli Astarlı Uzun Kol Midi/Orta Boy Şifon Elbise TBBAW24AH00027,119,2023-08-18,2025-03-07,567,101,18
Trendyol Curve Mavi Örme Cut-Out ve Büzgü Detaylı Çiçek Desenli Yazlık Örme Elbise TBBSS22AH0142,118,2022-03-16,2025-03-08,1088,109,9
Trendyol Curve Fuşya V Yaka Volanlı Örme Büyük Beden Elbise TBBSS23AH00030,118,2023-04-02,2025-03-10,708,107,11
TRENDYOLMİLLA Kırmızı A-Kesim Straplez Dokuma Şık Abiye Elbise TPRSS24EL00139,118,2024-05-16,2025-03-10,298,100,18
Trendyol Curve Kahverengi Büzgü Detaylı Midi Örme Elbise TBBSS24AH00080,118,2024-03-14,2025-03-10,361,96,22
TRENDYOLMİLLA Siyah Cepli Premium Bisiklet Yaka A-Line Örme Midi Elbise TWOSS24EL00169,118,2024-03-01,2024-11-23,267,103,15
TRENDYOLMİLLA Siyah Sırt Detaylı Askılı Bürümcük/Dokulu Maxi Örme Elbise TWOSS24EL00259,118,2024-03-20,2024-11-07,232,90,28
TRENDYOLMİLLA Siyah Düz Esnek Örme Elbise TWOSS24EL00412,117,2024-03-05,2024-12-20,290,99,18
TRENDYOLMİLLA X Zeynep Tosun Ekru Volanlı Parlak Taşlı Bridal Elbise TCLSS23EL00014,117,2023-05-24,2025-01-16,603,99,18
Trendyol Curve Koyu Mavi Comfort Denim Büyük Beden Elbise TBBSS24AH00206,117,2024-05-28,2025-03-10,286,105,12
TRENDYOLMİLLA Siyah Sırt Dekolteli Fitted/Vücuda Oturan Maxi Esnek Örme Maxi Kalem Elbise TWOSS24EL00090,117,2024-02-19,2025-03-03,378,108,9
Trendyol Curve Antrasit Belden Açılan/Skater V Yaka Denim Elbise TBBSS23AH00078,117,2023-03-29,2024-12-03,615,99,18
TRENDYOLMİLLA Lacivert A-Kesim Saten Dokuma Şık Abiye & Mezuniyet Elbise TPRAW25EL00040,117,2024-09-24,2025-03-10,167,105,12
TRENDYOLMİLLA Gül Kurusu A-Kesim Astarlı Volanlı Dokuma Şifon Kısa Şık Abiye Elbise TPRSS23EL00096,116,2024-02-29,2025-03-08,373,94,22
TRENDYOLMİLLA Siyah A-Kesim Askı Bağlama Detaylı Dokuma Elbise TPRSS24EL00251,116,2024-07-02,2025-02-11,224,108,8
TRENDYOLMİLLA Siyah A-Kesim Taş Aksesuarlı Dokuma Elbise TPRSS24EL00178,116,2024-07-02,2025-03-07,248,106,10
Trendyol Curve Çok Renkli Çiçek Desenli Dokuma Fırfır Detaylı Elbise TBBSS22EL1600,116,2022-05-12,2024-11-07,910,97,19
TRENDYOLMİLLA Antrasit Mini Triko A-Line Formda Elbise TWOAW25EL00030,116,2024-09-10,2025-03-10,181,95,21
TRENDYOLMİLLA Siyah Belden Açılan Üst Bedeni Gipeli Tek Omuz Midi Dokuma Elbise TWOSS23EL01830,116,2024-03-26,2025-02-21,332,108,8
TRENDYOLMİLLA Saks Vücuda Oturan Dokuma Elbise TPRSS24EL00136,116,2024-05-08,2025-03-04,300,92,24
TRENDYOLMİLLA Kahverengi Çok Renkli Hayvan Desenli Leopar Örme Tül Şık Abiye Elbise TPRSS24EL00202,116,2024-06-04,2025-03-10,279,107,9
TRENDYOLMİLLA Kırmızı Vücuda Oturan Çiçekli Örme Kısa Şık Abiye Elbise TPRSS24EL00112,115,2024-03-15,2025-01-23,314,104,11
TRENDYOLMİLLA Lacivert Desenli Askılı Vücuda Oturan Fitilli Esnek Örme Maxi Kalem Elbise TWOSS24EL00682,115,2024-03-25,2025-02-01,313,97,18
TRENDYOLMİLLA Yeşil Çiçekli Baskılı Parlak Yüzeyli Kayık Kaya Vücuda Oturan Esnek Örme Kalem Elbise TWOSS24EL00528,115,2024-03-22,2025-03-10,353,96,19
TRENDYOLMİLLA Lacivert Maxi Triko Polo Yaka Elbise TWOSS24EL00282,115,2024-04-11,2025-03-08,331,97,18
Trendyol Curve Çok Renkli Çiçek Desenli Şifon Kruvaze Dokuma Elbise TBBSS24AH00154,115,2024-04-18,2025-03-02,318,106,9
TRENDYOLMİLLA Mavi Çiçekli Baskılı Parlak Yüzeyli Kayık Kaya Vücuda Oturan Esnek Örme Kalem Elbise TWOSS24EL00528,114,2024-06-20,2025-03-10,263,105,9
TRENDYOLMİLLA Yeşil Çiçek Desenli A-Kesim Fırfır Detaylı Astarlı Şifon Maxi Dokuma Elbise TWOSS23EL02013,114,2024-02-17,2025-03-05,382,88,26
TRENDYOLMİLLA Çok Renkli Kuşaklı Eteği Volanlı Astarlı Şifon Mini Dokuma Kışlık Elbise TWOAW24EL00665,114,2023-09-30,2025-03-09,526,107,7
TRENDYOLMİLLA Lacivert Polo Yaka Skater/Belden Açılan Pamuklu Esnek Örme Midi Elbise TWOSS24EL00480,114,2024-05-17,2024-12-15,212,95,19
TRENDYOLMİLLA Siyah Piliseli Mini Dokuma Ceket Elbise TWOAW24EL00295,114,2023-09-12,2025-03-04,539,79,35
TRENDYOLMİLLA Siyah A-Kesim Dokuma Kısa Şık Abiye Elbise TPRSS24EL00074,114,2024-03-25,2025-03-06,346,98,16
TRENDYOLMİLLA Antrasit Yıkamalı/Soluk Efektli Shift/Düz Kesim Örme Elbise TWOSS24EL00126,114,2024-04-03,2025-03-04,335,97,17
Trendyol Curve Siyah Fitilli Midi Boy 2'li Triko Elbise&Crop Kazak Takım TBBAW24AH00004,114,2023-09-27,2025-03-07,527,98,16
TRENDYOLMİLLA Çok Renkli Çiçek Desenli A Kesim Astarlı Midi Dokuma Elbise TWOSS20EL0908,114,2023-07-16,2025-03-03,596,99,15
Trendyol Curve Bordo Örme Drape Detaylı Maxi/Uzun Abiye Elbise TBBSS22AD00000,114,2022-07-15,2025-02-08,939,96,18
TRENDYOLMİLLA Mavi Animal Shift Boyundan Bağlamalı Halter Yaka Shally Maxi Dokuma Elbise TWOSS24EL00872,114,2024-04-25,2025-03-11,320,96,18
TRENDYOLMİLLA Limited Edition Siyah Parlak Taşlı Tül Elbise TPRAW24EL00208,114,2023-10-23,2025-03-09,503,95,19
Trendyol Curve Siyah Çizgi Detaylı Triko Elbise TBBAW24AH00019,113,2023-09-01,2025-02-17,535,100,13
TRENDYOLMİLLA Siyah Maxi Dokuma Volanlı Plaj Elbisesi TBESS19WY0004,113,2022-08-02,2024-12-29,880,103,10
TRENDYOLMİLLA Beyaz Belden Açılan Kare Yaka Askılı Volanlı Mini Dokuma Elbise TWOSS23EL00601,113,2023-06-07,2024-08-28,448,92,21
TRENDYOLMİLLA Beyaz Düz Bodycone Krep Mini Dokuma Elbise TWOSS24EL00874,113,2024-04-08,2025-03-08,334,94,19
TRENDYOLMİLLA Ekru Maxi Dokuma Sırt Dekolteli Keten Karışımlı Plaj Elbisesi TBESS24EL00096,113,2024-05-21,2025-03-04,287,101,12
Trendyol Curve Siyah Yırtmaçlı Midi Örme Elbise TBBAW24AH00095,113,2023-09-16,2025-03-10,541,96,17
Trendyol Curve Mavi Belden Açılan/Skater V Yaka Denim Elbise TBBSS23AH00078,113,2023-02-22,2025-03-09,746,100,13
TRENDYOLMİLLA Tarçın Düğme Detaylı Gabardin Mini Dokuma Gömlek Elbise TWOSS22EL2970,113,2023-04-02,2025-03-07,705,76,37
TRENDYOLMİLLA Çok Renkli Astarlı A-Kesim Çiçek Desenli Örme Tül Kısa Şık Abiye Elbise TPRSS23EL00144,113,2023-03-15,2025-03-08,724,103,10
TRENDYOLMİLLA Siyah Jile Skater/Belden Açılan Örme Elbise TWOAW24EL00245,113,2023-08-26,2025-03-03,555,100,13
TRENDYOLMİLLA Haki Vücuda Oturan Mini Triko Sırt Dekolteli Plaj Elbisesi TBESS23EL00240,112,2023-04-04,2025-03-10,706,93,19
TRENDYOLMİLLA Siyah Kemerli Kruvaze Yaka Dokuma Elbise TWOAW20EL0909,112,2022-03-12,2024-12-28,1022,95,17
TRENDYOLMİLLA Indigo Belden Açılan Midi Korse Dikiş Detaylı Dokuma Elbise TWOSS24EL00038,112,2024-05-17,2025-03-11,298,82,30
TRENDYOLMİLLA Plaj Giyim Soyut Desenli Mini Dokuma Cut Out/Pencere %100 Pamuklu Elbise TBESS23EL00175,112,2023-03-15,2025-03-11,727,97,15
TRENDYOLMİLLA Bordo Tek Kol Vücuda Oturan Aksesuar Detaylı Tül Esnek Örme Midi Kalem Elbise TWOSS24EL00174,112,2024-04-26,2024-10-15,172,107,5
TRENDYOLMİLLA Bridal Ekru A-Kesim Astarlı Korse Detaylı Biyeli Dokuma Kısa Abiye Gece Elbise TPRSS23EL00251,112,2023-04-15,2025-03-05,690,80,32
Trendyol Curve Fuşya Büyük Beden Astarsız Truvakar Kol Mini/Kısa Boy Dokuma Ceket Elbise TBBAW23AH00042,111,2023-04-15,2025-03-06,691,95,16
TRENDYOLMİLLA Pembe A-Kesim Fiyonk Detaylı Dokuma Şık Abiye Elbise TPRSS24EL00105,111,2024-02-06,2024-12-30,328,91,20
TRENDYOLMİLLA Kiremit Vücuda Oturan Midi Triko Hırka Elbise Takım TWOSS21EL0208,111,2023-08-19,2025-02-18,549,96,15
TRENDYOLMİLLA Turuncu Çiçek Desenli Düz Kesim Halter Yaka Midi Saten Astarlı Dokuma Elbise TWOSS23EL02417,111,2023-05-27,2024-07-26,426,95,16
TRENDYOLMİLLA Altın Vücuda Oturan Parıltılı Örme Pullu Payet Kısa Şık Abiye Elbise TPRAW24EL00159,111,2023-09-30,2025-02-18,507,85,26
TRENDYOLMİLLA Siyah A-Kesim Astarlı Dokuma Şifon Şık Mini Abiye Elbise TPRSS23EL00131,111,2022-12-19,2025-02-16,790,96,15
TRENDYOLMİLLA Siyah V Yaka Düğme Detaylı Dokuma Midi Gömlek Elbise TWOSS23EL02158,111,2023-04-07,2025-03-04,697,100,11
TRENDYOLMİLLA Çok Renkli Soyut Desenli Örme Şık Abiye Elbise TPRSS24EL00150,111,2024-03-18,2025-01-31,319,99,12
TRENDYOLMİLLA Mavi Şal Desenli A-line Bağlama Detaylı Midi Dokuma Elbise TWOSS24EL00458,111,2024-03-06,2025-03-09,368,96,15
TRENDYOLMİLLA Saks Vücuda Oturan Pencere/Cut Out Detaylı Örme Kısa Şık Abiye Elbise TPRAW24EL00063,110,2023-09-07,2025-02-06,518,97,13
TRENDYOLMİLLA Siyah A Kesim Mini Tüvit Dokuma Elbise TWOAW23EL00258,110,2022-10-03,2025-01-20,840,84,26
TRENDYOLMİLLA Plaj Giyim Etnik Desenli Mini Dokuma Cut Out/Pencere %100 Pamuklu Elbise TBESS23EL00140,110,2023-03-28,2024-09-20,542,63,47
Trendyol Curve Siyah Kare Yaka Vücuda Oturan Triko Elbise TBBAW24AH00005,110,2023-07-14,2025-03-07,602,98,12
Trendyol Curve Siyah Yumoş Hırka-Elbise Örme 2'li Takım Büyük Beden Elbise TBBAW23AH00004,110,2022-10-07,2025-03-03,878,93,17
Trendyol Curve Siyah V-Yaka Büyük Beden Tüvit Jile Mini/Kısa Boy Dokuma Elbise TBBAW23AH00193,110,2022-11-09,2025-01-13,796,86,24
TRENDYOLMİLLA Siyah Baskılı Ayarlanabilir Askılı A-Line Bürümcük/Dokulu Örme Maxi Elbise TWOSS24EL00060,110,2024-03-03,2025-03-09,371,93,17
TRENDYOLMİLLA Siyah Fitted Vücuda Oturan Kayık Yaka Sıfır Kol Esnek Örme Örme Midi Kalem Elbise TWOSS24EL00662,109,2024-03-31,2025-02-12,318,97,12
Trendyol Curve Siyah Dokuma Carmen Yaka Bel Detaylı Elbise TBBSS23AH00090,109,2023-03-08,2025-03-10,733,96,13
TRENDYOLMİLLA Lacivert Kuşaklı A-Kesim Astarlı Piliseli Örme Kısa Şık Abiye Elbise TPRAW24EL00108,108,2023-08-30,2025-02-19,539,87,21
Trendyol Curve Siyah Kemerli Dokuma Kruvaze Yaka Elbise TBBSS23AH00206,108,2023-04-03,2025-03-05,702,92,16
TRENDYOLMİLLA Çok Renkli Çiçekli Dik Yaka Vatkalı Bodycone/Vücuda Oturan Örme Maxi Kalem Elbise TWOSS24EL00841,108,2024-03-13,2024-12-26,288,94,14
TRENDYOLMİLLA Kahverengi Leopar Desenli Düz Kesim Mini Saten Dokuma Elbise TWOSS24EL01065,108,2024-06-22,2025-03-10,261,86,22
TRENDYOLMİLLA Ekru Çiçek Desenli A Kesim Kat Kat Mini Astarlı Şifon Dokuma Elbise TWOSS23EL02056,108,2024-04-15,2025-03-06,325,92,16
TRENDYOLMİLLA Zümrüt A Kesim Yeşili Eteği Volanlı Saten Dokuma Elbise TWOAW21EL1891,108,2023-09-28,2025-02-27,518,95,13
TRENDYOLMİLLA Siyah Cep Görünümlü Belden Açılan/Skater Mini Smart Krep Örme Elbise TWOSS23EL01802,107,2023-03-24,2024-06-10,444,84,23
TRENDYOLMİLLA Bridal Ekru Yaka Detaylı Dokuma Abiye Gece Elbise TPRSS22EL3197,107,2022-04-29,2024-12-12,958,91,16
TRENDYOLMİLLA Koyu Mavi Volanlı Oversize Mini Denim Elbise TWOSS23EL01942,106,2023-05-24,2024-08-17,451,95,11
TRENDYOLMİLLA Lacivert Mini Düğmeli Viskon Dokuma Elbise TWOAW23EL01310,106,2022-08-20,2025-03-02,925,82,24
Trendyol Curve Siyah Kemer Detaylı Örme Şık Abiye Elbise TBBAW24EL00001,106,2023-08-19,2025-03-04,563,86,20
TRENDYOLMİLLA Ekru Brode Midi Dokuma Gömlek Elbise TWOSS23EL01024,105,2023-03-06,2024-12-18,653,85,20
TRENDYOLMİLLA Lacivert Tek Omuzlu Drapeli Fitted/Vücuda Oturan Maxi Esnek Örme Midi Kalem Elbise TWOSS24EL00100,105,2024-03-05,2024-11-27,267,93,12
TRENDYOLMİLLA Ekru Tüvit Dokuma Elbise TWOAW23EL00701,105,2022-11-12,2025-03-10,849,78,27
TRENDYOLMİLLA Kahverengi Midi Dokuma Sırt Dekolteli Plaj Elbisesi TBESS22EL0727,104,2022-04-29,2025-02-06,1014,93,11
TRENDYOLMİLLA Beyaz Dokuma %100 Pamuk Şerit Aksesuarlı Mini Plaj Elbisesi TBESS21EL1253,103,2022-03-31,2025-03-08,1073,85,18
TRENDYOLMİLLA Siyah Vücuda Oturan Gipeli Mini Dokuma Elbise TWOSS23EL00892,102,2023-03-14,2024-07-24,498,81,21
TRENDYOLMİLLA Çok Renkli Cut Out Detaylı Baskılı Esnek Midi Örme Elbise TWOSS23EL01809,99,2023-06-12,2024-12-04,541,96,3
TRENDYOLMİLLA Siyah Parlak Taşlı Dokuma Kısa Şık Abiye Elbise TPRSS23EL00091,99,2023-05-01,2024-09-21,509,78,21
TRENDYOLMİLLA Beyaz Belden Açılan Midi Astarlı Brode Dokuma Elbise TWOSS23EL00156,98,2023-04-15,2024-11-18,583,79,19
TRENDYOLMİLLA Siyah Düz Dokulu Fitted/Vücuda Oturan Maxi Örme Elbise TWOAW25EL00097,90,2024-09-19,2025-02-17,151,83,7
Edit by Trendyol Siyah Vücuda Oturan Asimetrik Yaka Örme Kısa Elbise TEDAW25EL00006,90,2024-08-08,2025-03-09,213,62,28
TRENDYOLMİLLA Antrasit Skater/Eteği Belden Açılan Bisiklet Yaka Mini Poliviskon Dokuma Elbise TWOAW25EL00244,89,2024-08-27,2025-03-08,193,79,10
Trendyol Curve Siyah V Yaka Balon Kol Mini/Kısa Boy Dokuma Elbise TBBAW24AH00038,89,2023-08-13,2025-02-26,563,78,11
TRENDYOLMİLLA Kırmızı Vücuda Oturan Dokuma Elbise TPRSS24EL00136,89,2024-06-05,2025-02-19,259,79,10
TRENDYOLMİLLA Bridal Beyaz A-Kesim Straplez Dokuma Düğün/Nikah Abiye Elbise TPRSS24EL00139,89,2024-03-14,2025-03-10,361,69,20
Trendyol Curve Siyah Taş İşlemeli Uzun Kol Yırtmaçlı Dokuma Abiye/Mezuniyet/Nişan/Gece Elbisesi TBBAW24AD00001,89,2023-10-18,2025-03-05,504,72,17
TRENDYOLMİLLA Siyah Düz Midi Vatkalı Drapeli Bodycone/Vücuda Oturan Esnek Elbise Örme Elbise TWOSS24EL00975,89,2024-07-06,2025-03-07,244,84,5
TRENDYOLMİLLA Kahverengi Eteği Belden Açılan Mini Dokuma Gömlek Elbise TWOAW25EL00154,89,2024-10-12,2025-03-09,148,60,29
TRENDYOLMİLLA Siyah Vücuda Oturan Örme Parıltılı Pullu Örme Payet Şık Abiye Elbise TPRSS24EL00030,89,2024-03-20,2025-03-10,355,78,11
TRENDYOLMİLLA Mavi Etek Ucu Püsküllü Kemerli Maxi Denim Elbise TWOSS24EL00377,89,2024-03-02,2025-03-10,373,69,20
TRENDYOLMİLLA Siyah A Kesim Mini Dokuma Elbise TWOAW25EL00192,89,2024-09-07,2025-03-10,184,74,15
TRENDYOLMİLLA Yeşil Mini Balon Kollu V Yaka Süet Dokuma Elbise TWOAW24EL00583,88,2023-09-15,2025-03-03,535,67,21
TRENDYOLMİLLA Siyah Yaka Detaylı A-Kesim Dokuma Şık Abiye Elbise TPRSS24EL00210,88,2024-06-13,2025-02-27,259,78,10
Trendyol Curve Siyah Yırtmaç Detaylı Midi %100 Pamuk Örme Büyük Beden Elbise TBBSS24AH00003,88,2024-02-15,2025-03-02,381,82,6
TRENDYOLMİLLA Siyah Asimetrik Yaka Bodycone/Vücuda Oturan Mini Örme Elbise TWOAW25EL00595,88,2024-10-31,2025-03-07,127,76,12
Trendyol Curve Siyah Uzun Kol Vücuda Oturan Yırtmaçlı Midi/Orta Boy Dokuma Elbise TBBAW24AH00089,88,2023-10-07,2024-12-01,421,63,25
TRENDYOLMİLLA Ekru Belden Açılan Şifon Astarlı Midi Dokuma Elbise TWOSS24EL00541,88,2024-04-22,2025-03-07,319,55,33
TRENDYOLMİLLA Pudra A-Kesim Dokuma Şık Abiye Elbise TPRSS24EL00160,88,2024-04-08,2025-03-09,335,75,13
TRENDYOLMİLLA Lacivert Maxi Triko Premium Kalite Elbise TWOSS24EL00301,87,2024-04-04,2025-02-22,324,74,13
TRENDYOLMİLLA Koyu Mavi Fermuarlı Fitted/Vücuda Oturan Mini Denim Elbise TWOSS24EL00381,87,2024-03-20,2025-03-05,350,76,11
TRENDYOLMİLLA Vizon Fitted/Vücuda Oturan Volanlı Midi Dokuma Elbise TWOSS20EL1342,87,2022-03-21,2025-02-19,1066,72,15
Trendyol Curve Siyah Polo Yaka Çizgili Mini %100 Pamuk Örme Büyük Beden Elbise TBBSS24AH00006,87,2024-02-21,2025-03-10,383,76,11
TRENDYOLMİLLA Limited Edition Mavi Gül Detaylı Mini Denim Gömlek Elbise TWOAW25EL00396,87,2024-09-05,2025-03-10,186,75,12
TRENDYOLMİLLA Siyah Kare Yaka Eteği Fırfırlı Bele Oturan Mini Örme Elbise TWOAW24EL00525,87,2023-09-15,2025-03-05,537,75,12
TRENDYOLMİLLA Limited Edition Siyah V Yaka Skater/Belden Açılan Esnek Maxi Örme Elbise TWOAW25EL00299,87,2024-09-11,2025-02-28,170,79,8
TRENDYOLMİLLA Siyah Vücuda Oturan Örme Kadife Midi Elbise TPRAW25EL00135,87,2024-10-12,2025-03-09,148,80,7
TRENDYOLMİLLA Kahverengi Pencere/Cut Out Detaylı Örme Tül Elbise TPRSS24EL00022,87,2024-04-05,2025-03-08,337,61,26
TRENDYOLMİLLA Siyah A-Kesim Poplin Dokuma Midi Şık Elbise TPRSS24EL00294,87,2024-08-21,2025-03-05,196,58,29
TRENDYOLMİLLA Bridal Beyaz A-Kesim Astarlı Dokuma Kısa Düğün/Nikah Şık Abiye Elbise TPRSS24EL00117,87,2024-03-03,2025-03-05,367,77,10
TRENDYOLMİLLA Zümrüt Yeşili Çiçek Baskılı Mini Selanik Dik Yaka Örme Elbise TWOAW25EL00282,86,2024-11-19,2025-03-09,110,80,6
TRENDYOLMİLLA Siyah Piliseli Astarlı Kolsuz Esnek Örme Midi Elbise TWOSS24EL00785,86,2024-05-31,2025-03-07,280,83,3
TRENDYOLMİLLA Bridal Beyaz Kol Detaylı Dokuma Düğün/Nikah Şık Abiye Elbise TPRSS24EL00119,86,2024-03-19,2025-03-02,348,72,14
TRENDYOLMİLLA Bordo Çiçek Baskılı Mini Selanik Dik Yaka Örme Elbise TWOAW25EL00282,86,2024-11-14,2025-03-10,116,75,11
TRENDYOLMİLLA Haki Düğmeli Kolsuz Midi Dokuma Gömlek Elbise TWOSS24EL00442,86,2024-04-03,2024-11-25,236,68,18
TRENDYOLMİLLA Pembe Düz Bodycone Straplez Detaylı Finike Mini Dokuma Gömlek Elbise TWOSS24EL00751,86,2024-03-11,2025-03-10,364,67,19
TRENDYOLMİLLA Siyah Vücuda Oturan Parıltılı Abiye Elbise TPRAW24EL00097,86,2023-09-30,2025-02-28,517,81,5
TRENDYOLMİLLA Siyah Vücuda Oturan Parıltılı Simli Örme Kısa Şık Abiye Elbise TPRAW24EL00006,86,2023-09-21,2025-02-13,511,68,18
TRENDYOLMİLLA Ekru Vücudu Saran Yırtmaçlı Askılı Astarlı Midi Kalem Etek Dokuma Elbise TWOSS19BB0216,86,2022-03-14,2024-12-01,993,69,17
TRENDYOLMİLLA Kahverengi Baskılı Büzgü / Drape Maxi  Örme Elbise TWOAW25EL00408,86,2024-09-13,2025-03-09,177,81,5
TRENDYOLMİLLA Kahverengi Mini Triko Dantelli Elbise TWOAW22EL0011,86,2023-08-21,2025-03-10,567,73,13
TRENDYOLMİLLA Mavi A-Kesim Dokuma Şık Abiye Elbise TPRSS24EL00160,86,2024-04-16,2025-03-06,324,73,13
Trendyol Curve Pembe Astarlı Şifon Çiçekli Kare Yaka Balon Kol Dokuma Büyük Beden Elbise TBBSS24AH00189,86,2024-04-04,2024-12-27,267,72,14
Trendyol Curve Siyah Dik Yaka Transparan Detaylı Bodycon Triko Elbise TBBAW23AH00180,86,2022-11-07,2025-02-28,844,71,15
TRENDYOLMİLLA Kırmızı Eteği Belden Açılan Pamuk Karışımlı Maxi Dokuma Elbise TWOSS24EL00386,86,2024-03-20,2024-12-18,273,75,11
TRENDYOLMİLLA Zümrüt Yeşili Vücuda Oturan Örme Parıltılı Pul Payet Şık Abiye Elbise TPRSS24EL00030,85,2024-07-25,2025-02-12,202,80,5
TRENDYOLMİLLA Siyah Kuşaklı A-Kesim Astarlı Piliseli Örme Kısa Şık Abiye Elbise TPRAW24EL00108,85,2023-09-06,2025-02-26,539,71,14
TRENDYOLMİLLA Zümrüt Yeşili A-Kesim Astarlı Volanlı Dokuma Şifon Kısa Şık Abiye Elbise TPRSS23EL00096,85,2023-08-31,2025-03-05,552,77,8
TRENDYOLMİLLA Çok Renkli A-Kesim Çiçek Desenli Fırfırlı Örme Tül Elbise TPRSS24EL00133,85,2024-03-18,2025-02-27,346,79,6
TRENDYOLMİLLA Altın Vücuda Oturan Örme Parıltılı Pullu Örme Payet Şık Abiye Elbise TPRSS24EL00030,85,2024-03-11,2025-03-07,361,74,11
TRENDYOLMİLLA Koyu Mavi Kuşaklı Maxi Modest Denim Gömlek Elbise TWOSS24EL00923,85,2024-08-17,2025-03-08,203,79,6
TRENDYOLMİLLA Siyah Vücuda Oturan Drapeli Örme Kısa Elbise TPRSS24EL00162,85,2024-03-30,2025-02-19,326,64,21
TRENDYOLMİLLA Zümrüt Yeşili Midi Triko Bisiklet Yaka Elbise TWOAW21EL0422,85,2023-08-08,2025-03-03,573,78,7
Trendyol Curve Kahverengi A-line Dokuma Elbise TBBSS24AH00052,85,2024-03-14,2024-12-01,262,77,8
TRENDYOLMİLLA Siyah A-Kesim Astarlı Agraflı Dokuma Şifon Kısa Şık Abiye Elbise TPRSS24EL00073,85,2024-02-09,2025-02-28,385,60,25
Trendyol Curve Siyah Şifon Kollu Midi Dokuma Büyük Beden Elbise TBBAW24AH00049,85,2023-09-05,2025-02-17,531,77,8
TRENDYOLMİLLA Mavi Kuşaklı Çizgili Mini Dokuma Gömlek Elbise TWOAW25EL00154,85,2024-07-18,2025-03-10,235,64,21
TRENDYOLMİLLA Çok Renkli Çiçek Desenli A Kesim V Yaka Astarlı Şifon Dokuma Elbise TWOAW24EL00320,85,2023-08-23,2025-03-10,565,74,11
TRENDYOLMİLLA Siyah Kruvaze Pilise Detaylı Mini Dokuma Elbise TWOSS24EL00793,84,2024-05-21,2025-02-10,265,63,21
TRENDYOLMİLLA Siyah Cut Out/Pencere Detaylı Örme Şık Abiye Elbise TPRAW25EL00022,84,2024-10-03,2025-03-10,158,78,6
TRENDYOLMİLLA Koyu Gri Volanlı Kare Yaka Fitted/Vücuda Oturan Maxi Esnek Örme Elbise TWOAW24EL00613,84,2023-09-28,2025-02-27,518,70,14
TRENDYOLMİLLA Kırmızı Cut Out/Pencere Detaylı Örme Şık Abiye Elbise TPRAW25EL00022,84,2024-09-25,2025-03-09,165,70,14
TRENDYOLMİLLA Pembe Çizgili Kruvaze Yaka Midi Dokuma Elbise TWOSS23EL02233,84,2023-05-02,2024-10-14,531,67,17
TRENDYOLMİLLA Çok Renkli Ayarlanabilir Askılı Baskılı Askılı Bürümcük/Dokulu Örme Midi Elbise TWOSS24EL00401,84,2024-02-02,2025-02-27,391,64,20
TRENDYOLMİLLA Siyah Düz T-shirt Elbise %100 Pamuk Yırtmaç Detaylı Shift/Rahat Kesim Midi TWOSS24EL00140,84,2024-03-15,2025-03-11,361,67,17
TRENDYOLMİLLA Siyah Düz Kesim Saten Askılı Maxi Dokuma Elbise TWOSS24EL00163,84,2024-03-16,2025-02-11,332,62,22
Trendyol Curve Mor Kare Yaka Balon Kollu Dokuma Yırtmaçlı Astarlı Şifon Elbise TBBSS22AH0012,84,2023-02-05,2025-03-09,763,70,14
TRENDYOLMİLLA Siyah Vücuda Oturan Maxi Örme Cut Out/Pencere Plaj Elbisesi TBESS23EL00122,84,2023-04-06,2025-02-01,667,76,8
TRENDYOLMİLLA Siyah Puantiyeli Vücuda Oturan Astarlı Drapeli Örme Tül Kısa Şık Abiye Elbise TPRAW24EL00028,84,2023-08-23,2025-03-09,564,70,14
TRENDYOLMİLLA Siyah Polo Yaka Shift/Normal Kesim Midi Esnek Örme Elbise TWOSS24EL01012,84,2024-05-22,2025-02-12,266,75,9
TRENDYOLMİLLA Yağ Yeşil Vücuda Oturan Gül Detaylı Örme Kısa Şık Abiye Elbise TPRSS24EL00095,84,2024-03-09,2025-01-08,305,56,28
TRENDYOLMİLLA Siyah itted/Vücuda Oturan Yırtmaçlı Kare Yaka Esnek Örme Midi Kalem Elbise TWOSS24EL00679,84,2024-03-23,2025-02-07,321,74,10
Trendyol Curve Siyah Halter Yaka Dokuma Elbise TBBSS23AH00207,83,2023-05-24,2024-10-21,516,78,5
TRENDYOLMİLLA Siyah Parıltılı Örme Şık Abiye Elbise TPRSS24EL00037,83,2024-03-25,2025-03-11,351,80,3
TRENDYOLMİLLA Siyah Vücuda Oturan Örme Payet Kısa Şık Abiye Elbise TPRSS24EL00151,83,2024-03-25,2025-02-27,339,66,17
TRENDYOLMİLLA Antrasit  A Kesim Eteği Asimetrik Mini  Dokuma Elbise TWOAW24EL00496,83,2023-08-20,2025-02-27,557,53,30
TRENDYOLMİLLA Siyah Kuşaklı Mini Dokuma Gömlek Elbise TWOAW25EL00154,83,2024-08-20,2025-03-10,202,57,26
TRENDYOLMİLLA Bordo Kemerli Ceket Mini Düğme Detaylı Dokuma Elbise TWOAW20EL1156,83,2023-10-24,2025-03-09,502,65,18
Trendyol Curve Camel Maxi/Uzun Boy Yırtmaçlı Yazlık Leopar Desenli Dokuma Elbise TBBSS24AH00136,83,2024-03-11,2025-03-05,359,79,4
TRENDYOLMİLLA Siyah Tüvit Görünümlü Triko Mini Elbise TWOAW25EL00542,83,2024-09-23,2025-03-06,164,70,13
TRENDYOLMİLLA Kırmızı Piliseli Astarlı Şifon Dokuma Elbise TWOAW24EL00478,83,2023-10-01,2025-03-10,526,68,15
TRENDYOLMİLLA Kırmızı Vücuda Oturan Astarlı Dokuma Şık Abiye Elbise TPRSS23EL00541,83,2023-05-06,2025-03-07,671,67,16
TRENDYOLMİLLA Çok Renkli A-Kesim Gül Detaylı Dokuma Elbise TPRSS24EL00098,83,2024-04-18,2024-12-08,234,49,34
TRENDYOLMİLLA X Sagaza Studio Siyah Belden Açılan/Skater Beli Lastikli Piliseli Poplin Elbise TCLAW24EL00000,83,2023-09-29,2025-03-07,525,61,22
TRENDYOLMİLLA Zümrüt Yeşili Baskılı Bodycone/Vücuda Oturan İspanyol Kol Mini Örme Kalem Elbise TWOAW24EL00191,83,2023-08-21,2025-03-09,566,73,10
Trendyol Curve Yeşil Dokuma Beli Lastik ve Düğme Detaylı Elbise TBBSS22EL1563,82,2023-01-25,2024-12-12,687,75,7
TRENDYOLMİLLA Taş Maxi Triko Saç Örgülü Geniş Kalıp Elbise TWOAW25EL00078,82,2024-08-24,2025-03-09,197,68,14
TRENDYOLMİLLA Bej Mini Triko Bolero-Elbise Takım TWOAW25EL00056,82,2024-09-12,2025-03-10,179,73,9
TRENDYOLMİLLA Kırmızı A-Kesim Astarlı Korse Detaylı Dokuma Kısa Şık Abiye Elbise TPRSS23EL00251,82,2023-04-27,2025-03-08,681,66,16
TRENDYOLMİLLA Mürdüm Çiçekli Fırfırlı Mini Dokuma Elbise TWOAW23EL01455,82,2024-09-13,2025-03-05,173,77,5
TRENDYOLMİLLA Lacivert Kemerli A Kesim Piliseli Maxi Astarlı Şifon Dokuma Elbise TWOAW24EL00471,82,2024-03-19,2025-03-11,357,66,16
TRENDYOLMİLLA Çok Renkli Kuşaklı Eteği Volanlı Viskon Dokuma Elbise TWOAW24EL00739,82,2023-10-05,2025-02-20,504,77,5
TRENDYOLMİLLA Bridal Beyaz Vücuda Oturan Çiçekli Örme Kısa Düğün/Nikah Şık Abiye Elbise TPRSS24EL00112,82,2024-03-09,2025-03-11,367,66,16
Trendyol Curve Siyah Puantiyeli Dokuma Gömlek Elbise TBBSS23AH00107,82,2023-03-09,2025-03-08,730,71,11
Trendyol Curve Siyah Yakası Çıtçıtlı Bodycone Fitilli Örme Büyük Beden Elbise TBBAW24AH00059,82,2023-10-20,2025-02-06,475,75,7
TRENDYOLMİLLA Limited Edition Haki Dokuma Saten Elbise TPRSS24EL00127,82,2024-03-15,2025-02-23,345,71,11
TRENDYOLMİLLA Kahverengi Askılı Dokuma Elbise TWOAW20EL0208,82,2022-03-14,2025-02-22,1076,70,12
TRENDYOLMİLLA Siyah Vücuda Oturan Parıltılı Örme Pullu Payet Kısa Şık Abiye Elbise TPRAW24EL00159,82,2023-09-24,2025-02-04,499,68,14
TRENDYOLMİLLA Siyah Vücuda Oturan Parlak Taşlı Dokuma Şık Abiye Elbise TPRSS24EL00128,82,2024-05-22,2025-03-05,287,74,8
Trendyol Curve Mint Kemerli Dokuma Gömlek Elbise TBBSS23AH00277,82,2023-07-09,2025-02-28,600,59,23
TRENDYOLMİLLA Çok Renkli Çiçek Desenli A-Kesim Fırfır Detaylı Astarlı Şifon Maxi Dokuma Elbise TWOSS23EL02013,81,2023-06-27,2025-03-10,622,71,10
Trendyol Curve Mavi Dokuma Beli Lastik ve Düğme Detaylı Elbise TBBSS22EL1563,81,2023-01-19,2025-01-05,717,66,15
TRENDYOLMİLLA Kırmızı Ayarlanabilir Askılı Kare Yaka A-Line Bürümcük/Dokulu Örme Maxi Elbise TWOSS24EL00060,81,2024-05-30,2025-02-05,251,67,14
TRENDYOLMİLLA Mavi Çiçek Desenli A-Kesim Kat Kat Mini Astarlı Şifon Dokuma Elbise TWOSS23EL02056,81,2024-03-31,2025-03-09,343,74,7
Trendyol Curve Siyah Kruvaze Bağlamalı Triko Elbise TBBAW23AH00014,81,2022-09-07,2025-03-10,915,63,18
TRENDYOLMİLLA Siyah Düz Maxi Kruvaze Detaylı A-line/Çan Açılan Melek Kol Örme Elbise TWOAW25EL00098,81,2024-08-28,2025-03-01,185,78,3
TRENDYOLMİLLA Siyah Düğme Detaylı Skater/Belden Açılan Midi Dokuma Elbise TWOSS22EL1185,81,2022-03-28,2025-02-03,1043,72,9
TRENDYOLMİLLA Siyah Düğmeli Hakim Yaka Dokuma Ceket Elbise TWOAW24EL00422,81,2023-09-04,2025-03-09,552,70,11
TRENDYOLMİLLA Zümrüt Yeşili Mini Triko Pileli Etek Detaylı Elbise TWOAW24EL00013,81,2023-08-22,2025-02-20,548,66,15
TRENDYOLMİLLA Turuncu Belden Açılan Bağlama Detaylı Midi Dokuma Elbise TWOSS23EL01913,81,2023-04-13,2025-02-12,671,68,13
TRENDYOLMİLLA Siyah Vücuda Oturan Tek Omuz Fiyonk Detaylı Dokuma Şık Midi Abiye Elbise TPRSS24EL00258,81,2024-07-08,2025-02-24,231,71,10
Trendyol Curve Zümrüt Yeşili Şifon Dokuma Büyük Beden Elbise,80,2024-09-21,2025-03-09,169,72,8
TRENDYOLMİLLA Siyah Biye Detaylı 2 Katmanlı İçi Şortlu Tenis Örme Spor Elbise THMSS24EL00000,80,2024-02-14,2025-02-26,378,62,18
TRENDYOLMİLLA Siyah Mini Triko Renk Bloklu Elbise TWOAW23EL00197,80,2022-09-18,2025-03-10,904,74,6
TRENDYOLMİLLA Çok Renkli Yırtmaçlı Desenli Dokuma Elbise TWOAW23EL00325,80,2023-09-06,2025-03-06,547,61,19
TRENDYOLMİLLA Pembe Çiçek Desenli Belden Açılan Mini Dokuma Elbise TWOSS23EL02008,80,2023-04-07,2024-10-15,557,70,10
TRENDYOLMİLLA Siyah Mini Triko Kontrast Renkli Elbise TWOAW24EL00041,80,2023-09-22,2025-02-15,512,68,12
TRENDYOLMİLLA Indigo Düğme Detaylı Dokuma Mini Ceket Dokuma Elbise  TWOAW23EL00291,80,2022-10-22,2025-03-02,862,60,20
TRENDYOLMİLLA Haki Kruvaze Dokuma Elbise TWOAW24EL00737,80,2023-09-26,2025-03-11,532,68,12
TRENDYOLMİLLA Siyah Saçaklı Payet Şık Abiye Elbise TPRAW24EL00277,80,2023-10-11,2025-02-01,479,64,16
TRENDYOLMİLLA Siyah Tül Astarlı Vücuda Oturan Midi Örme Elbise TWOAW24EL00164,80,2023-08-17,2025-03-11,572,64,16
TRENDYOLMİLLA Gül Kurusu Eteği Volanlı Sırt Bağlama Detaylı Askılı Maxi Dokuma Elbise TWOSS23EL00027,80,2023-04-08,2025-02-22,686,70,10
TRENDYOLMİLLA Mavi Dokuma %100 Pamuk Mini Plaj Elbisesi TBESS21EL3979,80,2022-07-06,2025-02-24,964,62,18
TRENDYOLMİLLA Kahverengi Düğme Detaylı Mini Dokuma Gömlek Elbise TWOAW23EL01424,80,2023-09-28,2025-02-25,516,72,8
TRENDYOLMİLLA Indigo Geniş Kesim Gömlek Yaka Maxi Dokuma Elbise TWOSS24EL00861,80,2024-04-27,2024-12-15,232,64,16
TRENDYOLMİLLA Yeşil Çiçekli A Kesim Yırtmaçlı Sırtı Gipe Detaylı Şifon Astarlı Midi Dokuma Elbise TWOSS24EL00699,80,2024-04-01,2025-02-28,333,60,20
Trendyol Curve Siyah Düz Kruvaze Kapama Şık Mini Dokuma Büyük Beden Elbise TBBAW24AH00058,79,2023-09-26,2025-02-27,520,68,11
TRENDYOLMİLLA Siyah Maxi Dokuma Sırt Dekolteli Keten Karışımlı Plaj Elbisesi TBESS24EL00096,79,2024-05-28,2025-03-04,280,72,7
TRENDYOLMİLLA Siyah Vücuda Oturan Parıltılı Örme Payet Şık Abiye Elbise TPRSS24EL00108,79,2024-05-29,2025-03-08,283,74,5
TRENDYOLMİLLA Soyut Desenli Mini Dokuma Sırt Dekolteli Plaj Elbisesi TBESS23EL00061,79,2023-03-22,2025-02-27,708,62,17
TRENDYOLMİLLA Pembe Kalıp Yaka Volanlı Dokuma Elbise TWOAW23EL01455,78,2023-09-15,2025-03-10,542,67,11
TRENDYOLMİLLA Kahverengi Carmen Yaka Fitted/Vücuda Oturan Esnek Örme Maxi Kalem Elbise TWOSS24EL00096,78,2024-02-29,2025-03-08,373,71,7
TRENDYOLMİLLA X Zeynep Tosun Saks Güneş Aksesuar Detaylı Cut Out Elbise TCLSS23EL00025,78,2023-05-25,2024-10-05,499,68,10
TRENDYOLMİLLA Pembe Çiçek Desenli Belden Açılan Mini Astarlı Şifon Dokuma Elbise TWOSS23EL01445,78,2023-04-13,2024-11-28,595,74,4
TRENDYOLMİLLA Kırmızı Bodycone Yırtmaçlı Fırfır Detaylı Esnek Kalın Sandy Maxi Kalem Elbise TWOSS24EL00688,78,2024-04-23,2025-03-08,319,69,9
TRENDYOLMİLLA Siyah Kalın Askılı Fitted/Vücuda Oturan Esnek Örme Maxi Kalem Elbise TWOSS24EL00137,77,2024-02-13,2025-02-27,380,71,6
TRENDYOLMİLLA Kırmızı Mini Triko Pileli Etek Detaylı Elbise TWOAW24EL00013,77,2023-08-21,2025-03-09,566,56,21
TRENDYOLMİLLA Siyah Scuba/Dalgıç 2 Katmanlı İçi Şortlu Tenis Örme Spor Elbise THMSS23EL00006,77,2023-03-30,2025-02-19,692,57,20
TRENDYOLMİLLA Mor Eteği Volanlı Mini Şifon Dokuma Kışlık Elbise TWOAW24EL00592,77,2023-09-19,2025-02-20,520,73,4
TRENDYOLMİLLA Siyah Kruvaze Bağlama Detaylı Mini Mono Desenli Dokuma Elbise TWOAW24EL00488,77,2023-09-22,2025-02-24,521,64,13
TRENDYOLMİLLA Mavi Dikiş Detaylı Fitted/Vücuda Oturan Mini Denim Elbise TWOSS24EL00284,76,2024-02-01,2025-03-05,398,67,9
TRENDYOLMİLLA Camel Kemerli Mini Dokuma Elbise TWOAW22EL0446,74,2022-03-18,2025-03-07,1085,58,16
TRENDYOLMİLLA Siyah Çiçekli Şifon Astarlı Dokuma Kışlık Elbise TWOAW23EL01436,71,2023-09-14,2025-01-20,494,61,10
Trendyol Curve Koyu Mavi Kuşak Detaylı Mini Denim Gömlek Elbise TBBSS24AH00124,70,2024-04-02,2025-02-12,316,60,10
